Apyg. Nr. Apylinkės sąraše;Apygardos pavadinimas;Apyl. Nr.;Apylinkės pavadinimas;Rinkėjų skaičius Iš viso;Iš viso vyrų;Iš viso moterų
1;Akmenės rajono;1;1 - Senamiesčio;1294;591;703
1;Akmenės rajono;2;2 - V. Kudirkos;1668;653;1015
1;Akmenės rajono;3;3 - Respublikos;1591;655;936
1;Akmenės rajono;4;4 - Ramučių;1170;521;649
1;Akmenės rajono;5;5 - Agluonų;339;166;173
1;Akmenės rajono;6;6 - Akmenės 1-oji;1936;872;1064
1;Akmenės rajono;7;7 - Alkiškių;352;178;174
1;Akmenės rajono;8;8 - Daubiškių;617;308;309
1;Akmenės rajono;9;9 - Kairiškių;258;139;119
1;Akmenės rajono;10;10 - Gulbinų;693;353;340
1;Akmenės rajono;11;11 - Kivylių;392;199;193
1;Akmenės rajono;12;12 - Kruopių;620;313;307
1;Akmenės rajono;15;15 - Pavenčio;1210;556;654
1;Akmenės rajono;16;16 - Papilės;1195;600;595
1;Akmenės rajono;17;17 - Luokavos;417;217;200
1;Akmenės rajono;18;18 - Sablauskių;328;158;170
1;Akmenės rajono;19;19 - Ventos;1252;552;700
1;Akmenės rajono;24;24 - Naujamiesčio;874;429;445
2;Alytaus miesto;1;1 - Amatų;1140;517;623
2;Alytaus miesto;2;2 - A. Ramanausko-Vanago;1371;622;749
2;Alytaus miesto;3;3 - Centro;1411;609;802
2;Alytaus miesto;4;4 - A. Matučio;1939;844;1095
2;Alytaus miesto;5;5 - Santaikos;1084;482;602
2;Alytaus miesto;6;6 - Pirmo Alytaus;2683;1263;1420
2;Alytaus miesto;8;8 - Naujoji;2934;1188;1746
2;Alytaus miesto;9;9 - Statybininkų;1339;557;782
2;Alytaus miesto;10;10 - Vilties;1762;737;1025
2;Alytaus miesto;11;11 - Sporto;1854;791;1063
2;Alytaus miesto;12;12 - Putinų;1751;752;999
2;Alytaus miesto;13;13 - Šaltinių;2415;1088;1327
2;Alytaus miesto;14;14 - Ūdrijos;1064;481;583
2;Alytaus miesto;17;17 - Gulbynės;3359;1453;1906
2;Alytaus miesto;18;18 - Vidzgirio;2643;1120;1523
2;Alytaus miesto;19;19 - Jotvingių;2122;916;1206
2;Alytaus miesto;20;20 - Topolių;1596;661;935
2;Alytaus miesto;21;21 - Volungės;3028;1301;1727
2;Alytaus miesto;22;22 - Jaunimo;2058;851;1207
2;Alytaus miesto;23;23 - Jurgiškių;2384;1069;1315
2;Alytaus miesto;24;24 - Likiškėlių;3110;1350;1760
3;Alytaus rajono;2;2 - Mikutiškių;748;388;360
3;Alytaus rajono;3;3 - Genių;383;203;180
3;Alytaus rajono;4;4 - Miklusėnų;1277;648;629
3;Alytaus rajono;6;6 - Luksnėnų;1034;528;506
3;Alytaus rajono;8;8 - Geištarų;1112;561;551
3;Alytaus rajono;9;9 - Miroslavo;1136;590;546
3;Alytaus rajono;12;12 - Parėčėnų;477;258;219
3;Alytaus rajono;14;14 - Kumečių;365;194;171
3;Alytaus rajono;15;15 - Vankiškių;418;222;196
3;Alytaus rajono;16;16 - Simno;1260;600;660
3;Alytaus rajono;17;17 - Mergalaukio;333;162;171
3;Alytaus rajono;18;18 - Kalesninkų;267;133;134
3;Alytaus rajono;20;20 - Ąžuolinių;326;182;144
3;Alytaus rajono;21;21 - Verebiejų;441;231;210
3;Alytaus rajono;23;23 - Krokialaukio;658;336;322
3;Alytaus rajono;24;24 - Ūdrijos;543;280;263
3;Alytaus rajono;25;25 - Santaikos;425;211;214
3;Alytaus rajono;26;26 - Punios;502;243;259
3;Alytaus rajono;27;27 - Raižių;230;119;111
3;Alytaus rajono;28;28 - Vaisodžių;1183;623;560
3;Alytaus rajono;29;29 - Žagarių;183;93;90
3;Alytaus rajono;30;30 - Butrimonių;997;486;511
3;Alytaus rajono;32;32 - Eičiūnų;410;225;185
3;Alytaus rajono;33;33 - Pivašiūnų;563;284;279
3;Alytaus rajono;35;35 - Junčionių;307;171;136
3;Alytaus rajono;36;36 - Jurgelionių;402;203;199
3;Alytaus rajono;38;38 - Daugų;1478;689;789
3;Alytaus rajono;40;40 - Vaikantonių;320;166;154
3;Alytaus rajono;41;41 - Rimėnų;480;252;228
3;Alytaus rajono;44;44 - Alytaus;1129;590;539
3;Alytaus rajono;45;45 - Venciūnų;1019;519;500
3;Alytaus rajono;46;46 - Alovės;678;346;332
3;Alytaus rajono;47;47 - Ilgų;335;159;176
3;Alytaus rajono;48;48 - Makniūnų;338;181;157
3;Alytaus rajono;49;49 - Ryliškių;251;133;118
3;Alytaus rajono;50;50 - Nemunaičio;912;456;456
4;Anykščių rajono;1;1 - Senamiesčio;2471;1120;1351
4;Anykščių rajono;2;2 - Janydžių;1271;516;755
4;Anykščių rajono;3;3 - Ažupiečių;1495;680;815
4;Anykščių rajono;4;4 - Liudiškių;2304;947;1357
4;Anykščių rajono;5;5 - Piktagalio;405;206;199
4;Anykščių rajono;6;6 - Ažuožerių;444;232;212
4;Anykščių rajono;7;7 - Elmos;900;462;438
4;Anykščių rajono;8;8 - Burbiškio;468;220;248
4;Anykščių rajono;9;9 - Šlavėnų;382;200;182
4;Anykščių rajono;10;10 - Debeikių;957;500;457
4;Anykščių rajono;11;11 - Leliūnų;298;141;157
4;Anykščių rajono;12;12 - Kavarsko;663;308;355
4;Anykščių rajono;13;13 - Dabužių;197;101;96
4;Anykščių rajono;14;14 - Janušavos;481;253;228
4;Anykščių rajono;15;15 - Svirnų;312;155;157
4;Anykščių rajono;16;16 - Šerių;242;113;129
4;Anykščių rajono;17;17 - Šovenių;104;52;52
4;Anykščių rajono;18;18 - Kurklių;373;181;192
4;Anykščių rajono;19;19 - Kurklių II k.;235;126;109
4;Anykščių rajono;20;20 - Staškūniškio;327;168;159
4;Anykščių rajono;21;21 - Katlėrių;276;144;132
4;Anykščių rajono;22;22 - Skiemonių;355;178;177
4;Anykščių rajono;23;23 - Mačionių;218;113;105
4;Anykščių rajono;25;25 - Aulelių;273;134;139
4;Anykščių rajono;26;26 - Svėdasų;1052;522;530
4;Anykščių rajono;27;27 - Vaitkūnų;220;114;106
4;Anykščių rajono;28;28 - Troškūnų;1014;497;517
4;Anykščių rajono;30;30 - Vašuokėnų;136;78;58
4;Anykščių rajono;31;31 - Surdegio;271;135;136
4;Anykščių rajono;32;32 - Nausodės;158;79;79
4;Anykščių rajono;33;33 - Raguvėlės;296;139;157
4;Anykščių rajono;34;34 - Levaniškių;237;124;113
4;Anykščių rajono;35;35 - Traupio;317;153;164
4;Anykščių rajono;36;36 - Andrioniškio;332;168;164
4;Anykščių rajono;37;37 - Viešintų;562;286;276
5;Birštono;1;1 - Birštono m.;2230;939;1291
5;Birštono;2;2 - Birštono vienkiemio;718;336;382
5;Birštono;3;3 - Nemajūnų;627;306;321
6;Biržų rajono;1;1 - Atžalyno;1852;858;994
6;Biržų rajono;2;2 - Rotušės;1167;505;662
6;Biržų rajono;3;3 - Aušros;2030;811;1219
6;Biržų rajono;4;4 - Saulės;1849;742;1107
6;Biržų rajono;5;5 - Kaštonų;2269;1015;1254
6;Biržų rajono;6;6 - Anglininkų;231;113;118
6;Biržų rajono;7;7 - Kratiškių;435;213;222
6;Biržų rajono;8;8 - Nausėdžių;295;155;140
6;Biržų rajono;9;9 - Obelaukių;669;315;354
6;Biržų rajono;10;10 - Rinkuškių;1328;662;666
6;Biržų rajono;11;11 - Germaniškio;363;187;176
6;Biržų rajono;12;12 - Nemunėlio Radviliškio;767;374;393
6;Biržų rajono;14;14 - Kirdonių;539;249;290
6;Biržų rajono;15;15 - Pabiržės;704;358;346
6;Biržų rajono;16;16 - Pačeriaukštės;340;172;168
6;Biržų rajono;17;17 - Pasvaliečių;369;184;185
6;Biržų rajono;18;18 - Juostaviečių;271;133;138
6;Biržų rajono;19;19 - Kučgalio;233;120;113
6;Biržų rajono;21;21 - Kupreliškio;249;125;124
6;Biržų rajono;22;22 - Kvetkų;249;134;115
6;Biržų rajono;23;23 - Papilio;552;286;266
6;Biržų rajono;24;24 - Medeikių;467;237;230
6;Biržų rajono;25;25 - Parovėjos;660;335;325
6;Biržų rajono;26;26 - Užušilių;313;164;149
6;Biržų rajono;27;27 - Ančiškių;223;125;98
6;Biržų rajono;28;28 - Jasiuliškių;236;125;111
6;Biržų rajono;29;29 - Meilūnų;274;132;142
6;Biržų rajono;30;30 - Ramongalių;274;136;138
6;Biržų rajono;31;31 - Šukionių;198;110;88
6;Biržų rajono;32;32 - Vabalninko;742;325;417
7;Druskininkų;1;1 - Senamiesčio;1367;577;790
7;Druskininkų;2;2 - Naujamiesčio;1190;464;726
7;Druskininkų;3;3 - Atgimimo;1471;558;913
7;Druskininkų;4;4 - Kloniškių;1804;759;1045
7;Druskininkų;5;5 - Kalviškės;2849;1138;1711
7;Druskininkų;6;6 - Eglės;1408;590;818
7;Druskininkų;7;7 - Ratnyčios;1131;576;555
7;Druskininkų;8;8 - Grūto;237;109;128
7;Druskininkų;9;9 - Švendubrės;235;124;111
7;Druskininkų;10;10 - Viečiūnų;1494;696;798
7;Druskininkų;11;11 - Neravų;1032;511;521
7;Druskininkų;12;12 - Leipalingio;1703;841;862
7;Druskininkų;13;13 - Lipliūnų;182;99;83
7;Druskininkų;14;14 - Ricielių;820;423;397
8;Elektrėnų;1;1 - Draugystės;1913;789;1124
8;Elektrėnų;2;2 - Saulės;4041;1934;2107
8;Elektrėnų;3;3 - Sodų;1745;737;1008
8;Elektrėnų;4;4 - Versmės;1940;861;1079
8;Elektrėnų;5;5 - Ausieniškių;1095;540;555
8;Elektrėnų;6;6 - Balceriškių;1306;654;652
8;Elektrėnų;7;7 - Beižionių;243;133;110
8;Elektrėnų;9;9 - Kazokiškių;372;191;181
8;Elektrėnų;10;10 - Pastrėvio;543;288;255
8;Elektrėnų;11;11 - Semeliškių;875;445;430
8;Elektrėnų;12;12 - Vievio;3520;1584;1936
8;Elektrėnų;13;13 - Gilučių;408;199;209
8;Elektrėnų;14;14 - Jagėlonių;268;156;112
8;Elektrėnų;15;15 - Kietaviškių;871;443;428
9;Ignalinos rajono;3;3 - Ceikinių;367;185;182
9;Ignalinos rajono;4;4 - Didžiasalio;1081;508;573
9;Ignalinos rajono;6;6 - Dūkšto;1122;552;570
9;Ignalinos rajono;9;9 - Ignalinos Centro;3004;1252;1752
9;Ignalinos rajono;10;10 - Ignalinos;1224;561;663
9;Ignalinos rajono;12;12 - Kazitiškio;658;328;330
9;Ignalinos rajono;13;13 - Kazokinės;605;325;280
9;Ignalinos rajono;14;14 - Linkmenų;690;370;320
9;Ignalinos rajono;17;17 - Mielagėnų;579;289;290
9;Ignalinos rajono;18;18 - N.Daugėliškio;920;499;421
9;Ignalinos rajono;20;20 - Rimšės;590;314;276
9;Ignalinos rajono;22;22 - Strigailiškio;449;229;220
9;Ignalinos rajono;26;26 - Tverečiaus;351;190;161
9;Ignalinos rajono;27;27 - Vidiškių;889;430;459
10;Jonavos rajono;1;1 - Rimkų;2887;1248;1639
10;Jonavos rajono;2;2 - Juodmenos;2364;1067;1297
10;Jonavos rajono;3;3 - Kregždutės;2509;1092;1417
10;Jonavos rajono;4;4 - Bibliotekos;1607;712;895
10;Jonavos rajono;6;6 - Senamiesčio;2324;1007;1317
10;Jonavos rajono;7;7 - Saulutės;1665;689;976
10;Jonavos rajono;8;8 - Mokyklos;1239;494;745
10;Jonavos rajono;9;9 - Ateities;1464;636;828
10;Jonavos rajono;10;10 - Kalnų;936;411;525
10;Jonavos rajono;11;11 - Lakštingalų;1594;749;845
10;Jonavos rajono;12;12 - Lietavos;2088;851;1237
10;Jonavos rajono;13;13 - Baldininkų;934;441;493
10;Jonavos rajono;14;14 - Ruklos;1624;751;873
10;Jonavos rajono;15;15 - Bukonių;532;265;267
10;Jonavos rajono;16;16 - Liepių;501;246;255
10;Jonavos rajono;17;17 - Batėgalos;450;245;205
10;Jonavos rajono;18;18 - Čičinų;856;447;409
10;Jonavos rajono;19;19 - Kulvos;462;226;236
10;Jonavos rajono;20;20 - Juškonių;317;152;165
10;Jonavos rajono;21;21 - Kuigalių;377;187;190
10;Jonavos rajono;22;22 - Žeimių;828;405;423
10;Jonavos rajono;23;23 - Panoterių;452;231;221
10;Jonavos rajono;24;24 - Šilų;1141;595;546
10;Jonavos rajono;25;25 - Upninkų;933;474;459
10;Jonavos rajono;26;26 - Užusalių;2063;1028;1035
10;Jonavos rajono;27;27 - Šveicarijos;2105;1074;1031
11;Joniškio rajono;1;1 - Žemaičių;2564;1079;1485
11;Joniškio rajono;2;2 - Livonijos;2507;1065;1442
11;Joniškio rajono;3;3 - V.Kudirkos;2428;1099;1329
11;Joniškio rajono;4;4 - Žagarės;1501;686;815
11;Joniškio rajono;5;5 - Bariūnų;383;186;197
11;Joniškio rajono;6;6 - Darginių;180;96;84
11;Joniškio rajono;7;7 - Daunoriškės;269;132;137
11;Joniškio rajono;8;8 - Daukšių;247;115;132
11;Joniškio rajono;9;9 - Gaižaičių;308;161;147
11;Joniškio rajono;10;10 - Gasčiūnų;338;174;164
11;Joniškio rajono;11;11 - Gataučių;447;218;229
11;Joniškio rajono;12;12 - Kalnelio;472;230;242
11;Joniškio rajono;13;13 - Plikiškių;198;102;96
11;Joniškio rajono;14;14 - Kepalių;303;150;153
11;Joniškio rajono;15;15 - Kirnaičių;278;140;138
11;Joniškio rajono;16;16 - Kriukų;369;190;179
11;Joniškio rajono;17;17 - Linkaičių;280;150;130
11;Joniškio rajono;18;18 - Maldenių;267;132;135
11;Joniškio rajono;19;19 - Mindaugių;234;121;113
11;Joniškio rajono;20;20 - Rudiškių;510;258;252
11;Joniškio rajono;21;21 - Satkūnų;302;158;144
11;Joniškio rajono;22;22 - Skaistgirio;1016;485;531
11;Joniškio rajono;23;23 - Stungių;252;117;135
11;Joniškio rajono;24;24 - Stupurų;241;124;117
11;Joniškio rajono;25;25 - Bučiūnų;136;69;67
11;Joniškio rajono;26;26 - Lieporų;139;75;64
11;Joniškio rajono;27;27 - Blauzdžiūnų;98;46;52
11;Joniškio rajono;28;28 - Jakiškių;156;80;76
11;Joniškio rajono;29;29 - Jauniūnų;211;110;101
11;Joniškio rajono;30;30 - Maželių;103;55;48
11;Joniškio rajono;31;31 - Mekių;143;75;68
11;Joniškio rajono;32;32 - Skilvionių;111;58;53
11;Joniškio rajono;33;33 - Ziniūnų;223;108;115
11;Joniškio rajono;34;34 - Jurdaičių;330;183;147
11;Joniškio rajono;35;35 - Drąsutaičių;113;61;52
11;Joniškio rajono;36;36 - Pošupių;209;116;93
12;Jurbarko rajono;1;1 - Viešvilės;691;340;351
12;Jurbarko rajono;2;2 - Smalininkų;939;443;496
12;Jurbarko rajono;3;3 - Jurbarkų;1252;625;627
12;Jurbarko rajono;4;4 - Rotulių;479;254;225
12;Jurbarko rajono;5;5 - Žindaičių;467;246;221
12;Jurbarko rajono;6;6 - Eržvilko;447;216;231
12;Jurbarko rajono;7;7 - Pašaltuonio;252;130;122
12;Jurbarko rajono;8;8 - Lybiškių;422;215;207
12;Jurbarko rajono;9;9 - Kartupių;290;144;146
12;Jurbarko rajono;10;10 - Rutkiškių;241;128;113
12;Jurbarko rajono;11;11 - Pavidaujo;267;135;132
12;Jurbarko rajono;12;12 - Girdžių;573;285;288
12;Jurbarko rajono;13;13 - Vadžgirio;547;275;272
12;Jurbarko rajono;14;14 - Šimkaičių;281;142;139
12;Jurbarko rajono;15;15 - Paulių;231;115;116
12;Jurbarko rajono;17;17 - Juodaičių;268;134;134
12;Jurbarko rajono;18;18 - Armeniškių;280;139;141
12;Jurbarko rajono;19;19 - Seredžiaus;644;308;336
12;Jurbarko rajono;20;20 - Klausučių;747;364;383
12;Jurbarko rajono;22;22 - Tamošių;385;179;206
12;Jurbarko rajono;23;23 - Veliuonos;694;338;356
12;Jurbarko rajono;24;24 - Stakių;373;196;177
12;Jurbarko rajono;25;25 - Raudonės;706;353;353
12;Jurbarko rajono;26;26 - Pilies;434;222;212
12;Jurbarko rajono;27;27 - Skirsnemunės;929;446;483
12;Jurbarko rajono;28;28 - Dariaus ir Girėno;2160;881;1279
12;Jurbarko rajono;29;29 - Vydūno;2207;1036;1171
12;Jurbarko rajono;30;30 - Vytauto Didžiojo;1485;642;843
12;Jurbarko rajono;31;31 - Naujamiesčio;2431;1007;1424
13;Kaišiadorių rajono;1;1 - Vytauto;894;416;478
13;Kaišiadorių rajono;2;2 - Gedimino;1215;512;703
13;Kaišiadorių rajono;3;3 - Girelės;2322;1004;1318
13;Kaišiadorių rajono;4;4 - Lomenos;2159;946;1213
13;Kaišiadorių rajono;5;5 - Kruonio;900;453;447
13;Kaišiadorių rajono;6;6 - Kalvių;372;204;168
13;Kaišiadorių rajono;7;7 - Vilūnų;389;194;195
13;Kaišiadorių rajono;8;8 - Darsūniškio;347;166;181
13;Kaišiadorių rajono;9;9 - Ringailių;296;148;148
13;Kaišiadorių rajono;12;12 - Stoniavos;673;338;335
13;Kaišiadorių rajono;13;13 - Dainių;493;236;257
13;Kaišiadorių rajono;14;14 - Stasiūnų;972;473;499
13;Kaišiadorių rajono;15;15 - Melioratorių;839;413;426
13;Kaišiadorių rajono;16;16 - Žiežmarių;1465;681;784
13;Kaišiadorių rajono;17;17 - Gudienos;1616;760;856
13;Kaišiadorių rajono;18;18 - Žaslių;649;342;307
13;Kaišiadorių rajono;19;19 - Pajautiškių;412;192;220
13;Kaišiadorių rajono;20;20 - Stabintiškių;491;252;239
13;Kaišiadorių rajono;22;22 - Tauckūnų;581;300;281
13;Kaišiadorių rajono;23;23 - Palomenės;578;275;303
13;Kaišiadorių rajono;24;24 - Zūbiškių;326;163;163
13;Kaišiadorių rajono;25;25 - Paparčių;535;265;270
13;Kaišiadorių rajono;26;26 - Rumšiškių;2047;1004;1043
13;Kaišiadorių rajono;27;27 - Pravieniškių;1114;537;577
13;Kaišiadorių rajono;28;28 - Dovainonių;750;374;376
13;Kaišiadorių rajono;29;29 - Antakalnio;592;300;292
13;Kaišiadorių rajono;31;31 - Liutonių;605;291;314
14;Kalvarijos;1;1 - Kalvarijos Vakarinė;1606;723;883
14;Kalvarijos;2;2 - Kalvarijos Rytinė;1572;718;854
14;Kalvarijos;3;3 - Jungėnų;1011;496;515
14;Kalvarijos;4;4 - Brukų;260;132;128
14;Kalvarijos;5;5 - Sūsninkų;254;126;128
14;Kalvarijos;6;6 - Mockų;239;116;123
14;Kalvarijos;7;7 - Jusevičių;541;261;280
14;Kalvarijos;8;8 - Sangrūdos;413;194;219
14;Kalvarijos;9;9 - Radiškės;250;126;124
14;Kalvarijos;10;10 - Salaperaugio;232;121;111
14;Kalvarijos;11;11 - Liubavo;235;120;115
14;Kalvarijos;12;12 - Brazavo;325;174;151
14;Kalvarijos;13;13 - Jurgežerių;245;132;113
14;Kalvarijos;14;14 - Tarprubežių;237;117;120
14;Kalvarijos;15;15 - Akmenynų;249;114;135
14;Kalvarijos;16;16 - Kampinių;279;144;135
14;Kalvarijos;17;17 - Aistiškių;250;122;128
15;Kauno miesto;2;2 - Sargėnų;4631;2110;2521
15;Kauno miesto;3;3 - Vėtrungės;2963;1200;1763
15;Kauno miesto;4;4 - Rasytės;2779;1175;1604
15;Kauno miesto;5;5 - Šarkuvos;3943;1668;2275
15;Kauno miesto;7;7 - Žemaičių;3686;1546;2140
15;Kauno miesto;8;8 - Baltų;3622;1542;2080
15;Kauno miesto;9;9 - Baltijos;3359;1450;1909
15;Kauno miesto;10;10 - Žiemgalių;4415;1955;2460
15;Kauno miesto;11;11 - Milikonių;2223;995;1228
15;Kauno miesto;12;12 - Demokratų;1814;761;1053
15;Kauno miesto;13;13 - Linkuvos;2430;1025;1405
15;Kauno miesto;15;15 - Sąjungos;2805;1147;1658
15;Kauno miesto;16;16 - Dobilo;2576;1130;1446
15;Kauno miesto;18;18 - Apuolės;997;488;509
15;Kauno miesto;19;19 - Seredžiaus;1455;660;795
15;Kauno miesto;21;21 - Veršvų;4608;2053;2555
15;Kauno miesto;22;22 - Žagarės;2075;939;1136
15;Kauno miesto;23;23 - Bivylių;3906;1858;2048
15;Kauno miesto;24;24 - Kaniūkų;1799;806;993
15;Kauno miesto;25;25 - Girios alėjos;2736;1302;1434
15;Kauno miesto;27;27 - J. Dobkevičiaus;4244;1899;2345
15;Kauno miesto;28;28 - Veiverių;1604;747;857
15;Kauno miesto;29;29 - Birutės;4163;1951;2212
15;Kauno miesto;30;30 - Julijanavos;1974;914;1060
15;Kauno miesto;31;31 - Piliakalnio;2513;1138;1375
15;Kauno miesto;33;33 - Tekstilininkų;1773;790;983
15;Kauno miesto;36;36 - Maironio;1588;707;881
15;Kauno miesto;37;37 - A. Mackevičiaus;1010;470;540
15;Kauno miesto;38;38 - Varpo;3117;1303;1814
15;Kauno miesto;40;40 - Radvilėnų;1995;827;1168
15;Kauno miesto;42;42 - J. Jablonskio;1704;731;973
15;Kauno miesto;43;43 - Aušros;2001;894;1107
15;Kauno miesto;45;45 - Senojo tresto;2591;1127;1464
15;Kauno miesto;49;49 - Miško;2856;1286;1570
15;Kauno miesto;50;50 - Jonavos;735;342;393
15;Kauno miesto;52;52 - L. Karsavino;3100;1356;1744
15;Kauno miesto;54;54 - Algirdo;2429;1069;1360
15;Kauno miesto;56;56 - Purienų;3054;1334;1720
15;Kauno miesto;58;58 - Žeimenos;3815;1563;2252
15;Kauno miesto;60;60 - Versmės;2533;1091;1442
15;Kauno miesto;61;61 - Gerovės;3823;1639;2184
15;Kauno miesto;63;63 - S. Nėries;4157;1833;2324
15;Kauno miesto;64;64 - Aukuro;3379;1418;1961
15;Kauno miesto;65;65 - Vaidilutės;1456;613;843
15;Kauno miesto;66;66 - Šiaurės;3108;1324;1784
15;Kauno miesto;67;67 - S. Žukausko;3242;1375;1867
15;Kauno miesto;68;68 - Statybininkų;3398;1401;1997
15;Kauno miesto;69;69 - Rasos;1653;680;973
15;Kauno miesto;70;70 - P. Plechavičiaus;3307;1378;1929
15;Kauno miesto;71;71 - K. Škirpos;3536;1503;2033
15;Kauno miesto;72;72 - P. Lukšio;3286;1346;1940
15;Kauno miesto;77;77 - Buitininkų;3974;1669;2305
15;Kauno miesto;78;78 - Partizanų;2822;1196;1626
15;Kauno miesto;79;79 - Pramonės;2082;864;1218
15;Kauno miesto;80;80 - Dainavos;2762;1136;1626
15;Kauno miesto;81;81 - J. Urbšio;2088;874;1214
15;Kauno miesto;82;82 - Sartų;2321;978;1343
15;Kauno miesto;83;83 - A. Timinskio;2221;908;1313
15;Kauno miesto;84;84 - Nepriklausomybės;1824;748;1076
15;Kauno miesto;85;85 - Vytauto;2880;1157;1723
15;Kauno miesto;86;86 - Atžalyno;3152;1357;1795
15;Kauno miesto;88;88 - V. Krėvės;1986;836;1150
15;Kauno miesto;89;89 - Specialistų;2351;1007;1344
15;Kauno miesto;91;91 - Taikos;1993;874;1119
15;Kauno miesto;92;92 - Vyturio;2161;885;1276
15;Kauno miesto;93;93 - Butrimonių;1929;807;1122
15;Kauno miesto;94;94 - Studentų;2471;1094;1377
15;Kauno miesto;96;96 - Dujotiekio;2608;1197;1411
15;Kauno miesto;97;97 - Girstučio;1765;711;1054
15;Kauno miesto;98;98 - Pašilės;2730;1221;1509
15;Kauno miesto;99;99 - Knygnešių;2263;948;1315
15;Kauno miesto;101;101 - Palemono;3206;1447;1759
15;Kauno miesto;105;105 - Sodų;3239;1428;1811
15;Kauno miesto;106;106 - Šančių;2288;1042;1246
15;Kauno miesto;107;107 - Drobės;2058;950;1108
15;Kauno miesto;108;108 - Skuodo;2174;1012;1162
15;Kauno miesto;109;109 - Žiburio;2903;1238;1665
15;Kauno miesto;110;110 - Breslaujos;2999;1279;1720
15;Kauno miesto;111;111 - Nemuno;1994;823;1171
15;Kauno miesto;114;114 - Šilo;3093;1440;1653
15;Kauno miesto;116;116 - Buriuotojų;3809;1653;2156
15;Kauno miesto;117;117 - Vaidoto;2391;1027;1364
15;Kauno miesto;118;118 - Pušų;2523;1102;1421
15;Kauno miesto;120;120 - Vičiūnų;2017;899;1118
15;Kauno miesto;121;121 - Ąžuolo;3379;1420;1959
15;Kauno miesto;122;122 - Rokų;2946;1377;1569
15;Kauno miesto;123;123 - Vaišvydavos;3123;1509;1614
15;Kauno miesto;125;125 - Kazliškių;1209;588;621
15;Kauno miesto;126;126 - Tirkiliškių;2776;1322;1454
15;Kauno miesto;127;127 - Romainių;2411;1158;1253
16;Kauno rajono;1;1 - Mastaičių;1887;923;964
16;Kauno rajono;2;2 - Pažėrų;774;391;383
16;Kauno rajono;4;4 - Babtų;1263;569;694
16;Kauno rajono;5;5 - Pagynės;580;299;281
16;Kauno rajono;6;6 - Panevėžiuko;976;504;472
16;Kauno rajono;7;7 - Čekiškės;693;344;349
16;Kauno rajono;8;8 - Liučiūnų;535;268;267
16;Kauno rajono;9;9 - Domeikavos;1781;875;906
16;Kauno rajono;10;10 - Neries;2045;970;1075
16;Kauno rajono;11;11 - Voškonių;968;460;508
16;Kauno rajono;12;12 - Lapių;2053;1002;1051
16;Kauno rajono;13;13 - Juragių;771;393;378
16;Kauno rajono;14;14 - Ilgakiemio;853;413;440
16;Kauno rajono;15;15 - Teleičių;2000;935;1065
16;Kauno rajono;16;16 - Karmėlavos;1238;564;674
16;Kauno rajono;17;17 - Ramučių;1356;663;693
16;Kauno rajono;18;18 - Neveronių;1332;627;705
16;Kauno rajono;19;19 - Universiteto;2461;1176;1285
16;Kauno rajono;20;20 - Akademijos;2094;967;1127
16;Kauno rajono;21;21 - Ringaudų;2467;1143;1324
16;Kauno rajono;23;23 - Raudondvario;1660;753;907
16;Kauno rajono;24;24 - Batniavos;985;475;510
16;Kauno rajono;26;26 - Nemuno;797;417;380
16;Kauno rajono;28;28 - Šlienavos;2452;1231;1221
16;Kauno rajono;29;29 - Girionių;1846;876;970
16;Kauno rajono;30;30 - Taurakiemio;1542;764;778
16;Kauno rajono;33;33 - Užliedžių;2659;1254;1405
16;Kauno rajono;34;34 - Vandžiogalos;1167;563;604
16;Kauno rajono;35;35 - Padauguvos;303;156;147
16;Kauno rajono;36;36 - Saulėtekių;524;265;259
16;Kauno rajono;37;37 - Daugėliškių;356;162;194
16;Kauno rajono;38;38 - Zapyškio;1489;758;731
16;Kauno rajono;39;39 - Altoniškių;784;424;360
16;Kauno rajono;40;40 - Ežerėlio;1318;593;725
16;Kauno rajono;41;41 - Garliavos;1966;939;1027
16;Kauno rajono;42;42 - Liepų;1781;819;962
16;Kauno rajono;43;43 - Jonučių;1690;806;884
16;Kauno rajono;44;44 - Kačerginės;631;293;338
16;Kauno rajono;45;45 - Kulautuvos;1254;581;673
16;Kauno rajono;46;46 - Vilkijos;1231;593;638
16;Kauno rajono;47;47 - Linksmakalnio;502;242;260
16;Kauno rajono;48;48 - Žalgirio;1677;779;898
16;Kauno rajono;49;49 - Meno mokyklos;1634;707;927
16;Kauno rajono;50;50 - Mokyklos;804;371;433
16;Kauno rajono;51;51 - Saulės;1793;882;911
16;Kauno rajono;52;52 - Bibliotekos;1469;665;804
16;Kauno rajono;53;53 - S. Lozoraičio;1961;857;1104
16;Kauno rajono;54;54 - Muniškių;1113;543;570
16;Kauno rajono;55;55 - Drąseikių;1328;688;640
16;Kauno rajono;56;56 - Įgulos;2249;1084;1165
16;Kauno rajono;57;57 - Sąnašos;1470;720;750
16;Kauno rajono;58;58 - Pelenių;1234;533;701
16;Kauno rajono;59;59 - Ąžuolų;1577;749;828
16;Kauno rajono;60;60 - Pabiržio;1602;783;819
16;Kauno rajono;61;61 - Tabariškių;3192;1592;1600
16;Kauno rajono;62;62 - Dvaro;1616;791;825
16;Kauno rajono;63;63 - Vijūkų;2423;1167;1256
16;Kauno rajono;64;64 - Giraitės;1227;616;611
16;Kauno rajono;65;65 - Uosiuko;1567;765;802
17;Kazlų Rūdos;1;1 - Kazlų Rūdos;1047;500;547
17;Kazlų Rūdos;2;2 - Pušų;1765;751;1014
17;Kazlų Rūdos;3;3 - Mindaugo;1282;591;691
17;Kazlų Rūdos;4;4 - Liepų;477;222;255
17;Kazlų Rūdos;5;5 - Bagotosios;455;236;219
17;Kazlų Rūdos;6;6 - Antanavo;567;276;291
17;Kazlų Rūdos;7;7 - Višakio Rūdos;361;184;177
17;Kazlų Rūdos;8;8 - Jūrės;588;317;271
17;Kazlų Rūdos;9;9 - Jūrės;337;164;173
17;Kazlų Rūdos;10;10 - Plutiškių;467;226;241
17;Kazlų Rūdos;11;11 - Ąžuolų Būdos;801;407;394
17;Kazlų Rūdos;12;12 - Bebruliškės;343;183;160
17;Kazlų Rūdos;13;13 - Būdos;301;154;147
17;Kazlų Rūdos;14;14 - Jankų;471;225;246
18;Kelmės rajono;1;1 - Budraičių;233;112;121
18;Kelmės rajono;2;2 - Butkiškės;194;99;95
18;Kelmės rajono;3;3 - Dubėnų;278;147;131
18;Kelmės rajono;4;4 - Gailių;284;146;138
18;Kelmės rajono;6;6 - Janaučių;554;295;259
18;Kelmės rajono;7;7 - Junkilų;305;150;155
18;Kelmės rajono;8;8 - Karklėnų;350;179;171
18;Kelmės rajono;9;9 - Centro;2446;1053;1393
18;Kelmės rajono;10;10 - A. Mackevičiaus;2664;1122;1542
18;Kelmės rajono;11;11 - Kalno;1887;872;1015
18;Kelmės rajono;12;12 - Kiaunorių;355;184;171
18;Kelmės rajono;13;13 - Kolainių;315;158;157
18;Kelmės rajono;14;14 - Kražių;646;308;338
18;Kelmės rajono;15;15 - Kukečių;626;316;310
18;Kelmės rajono;17;17 - Liolių;681;333;348
18;Kelmės rajono;18;18 - Lupikų;520;262;258
18;Kelmės rajono;19;19 - Maironių;657;345;312
18;Kelmės rajono;21;21 - Mockaičių;246;130;116
18;Kelmės rajono;22;22 - Pagryžuvio;627;303;324
18;Kelmės rajono;23;23 - Pakėvio;268;140;128
18;Kelmės rajono;24;24 - Pakražančio;510;255;255
18;Kelmės rajono;27;27 - Pašilės;207;109;98
18;Kelmės rajono;28;28 - Pavėžupio;196;101;95
18;Kelmės rajono;29;29 - Petrališkės;306;165;141
18;Kelmės rajono;30;30 - Stulgių;260;138;122
18;Kelmės rajono;31;31 - Šaltenių;300;163;137
18;Kelmės rajono;32;32 - Šaukėnų;805;385;420
18;Kelmės rajono;33;33 - Šedbarų;270;140;130
18;Kelmės rajono;35;35 - Tytuvėnų;1858;864;994
18;Kelmės rajono;36;36 - Užvenčio;1500;728;772
18;Kelmės rajono;37;37 - Vaiguvos;361;187;174
18;Kelmės rajono;38;38 - Valpainių;308;148;160
18;Kelmės rajono;39;39 - Verpenos;425;220;205
18;Kelmės rajono;40;40 - Vidsodžio;345;188;157
18;Kelmės rajono;41;41 - Žalpių;244;120;124
19;Kėdainių rajono;1;1 - Angirių;135;72;63
19;Kėdainių rajono;2;2 - Aristavos;485;233;252
19;Kėdainių rajono;3;3 - Ažytėnų;253;133;120
19;Kėdainių rajono;4;4 - Babėnų;2211;1022;1189
19;Kėdainių rajono;5;5 - Beinaičių;295;152;143
19;Kėdainių rajono;6;6 - Vikaičių;360;192;168
19;Kėdainių rajono;7;7 - Dotnuvos;1044;497;547
19;Kėdainių rajono;8;8 - Gudžiūnų;381;182;199
19;Kėdainių rajono;9;9 - Josvainių;1327;619;708
19;Kėdainių rajono;10;10 - Kalnaberžės;325;166;159
19;Kėdainių rajono;11;11 - Kaplių;206;93;113
19;Kėdainių rajono;12;12 - Keleriškių;729;382;347
19;Kėdainių rajono;13;13 - Krakių;697;328;369
19;Kėdainių rajono;14;14 - Kunionių;408;211;197
19;Kėdainių rajono;15;15 - Labūnavos;650;313;337
19;Kėdainių rajono;16;16 - Lančiūnavos;496;226;270
19;Kėdainių rajono;17;17 - Langakių;268;143;125
19;Kėdainių rajono;18;18 - Liaudies;2929;1261;1668
19;Kėdainių rajono;19;19 - Mantviliškio;247;127;120
19;Kėdainių rajono;21;21 - Meironiškio;293;151;142
19;Kėdainių rajono;22;22 - Naujoji;1617;635;982
19;Kėdainių rajono;23;23 - Miegėnų;353;189;164
19;Kėdainių rajono;24;24 - Nociūnų;527;275;252
19;Kėdainių rajono;25;25 - Okainių;278;145;133
19;Kėdainių rajono;26;26 - Paaluonio;180;88;92
19;Kėdainių rajono;27;27 - Pagirių;341;157;184
19;Kėdainių rajono;28;28 - Pajieslio;337;161;176
19;Kėdainių rajono;29;29 - Parko;1030;449;581
19;Kėdainių rajono;30;30 - Pašušvio;297;139;158
19;Kėdainių rajono;31;31 - Pelėdnagių;1545;758;787
19;Kėdainių rajono;32;32 - Pelutavos;237;114;123
19;Kėdainių rajono;33;33 - Pergalės;2145;900;1245
19;Kėdainių rajono;34;34 - Pernaravos;282;137;145
19;Kėdainių rajono;35;35 - Petkūnų;138;75;63
19;Kėdainių rajono;36;36 - Radvilų;1871;773;1098
19;Kėdainių rajono;38;38 - Senamiesčio;983;454;529
19;Kėdainių rajono;39;39 - Sirutiškio;338;165;173
19;Kėdainių rajono;40;40 - Skaistgirių;226;116;110
19;Kėdainių rajono;41;41 - Smilgos;1360;603;757
19;Kėdainių rajono;42;42 - Statybininkų;1035;467;568
19;Kėdainių rajono;43;43 - Surviliškio;394;187;207
19;Kėdainių rajono;44;44 - Šėtos;814;397;417
19;Kėdainių rajono;45;45 - Šlapaberžės;457;239;218
19;Kėdainių rajono;46;46 - Taikos;2034;850;1184
19;Kėdainių rajono;47;47 - Tiskūnų;691;358;333
19;Kėdainių rajono;48;48 - Truskavos;368;175;193
19;Kėdainių rajono;49;49 - Vainikų;326;165;161
19;Kėdainių rajono;50;50 - Vilainių;1019;464;555
19;Kėdainių rajono;51;51 - Žemaitės;1712;686;1026
19;Kėdainių rajono;52;52 - Akademijos;547;238;309
19;Kėdainių rajono;53;53 - Beržų;286;151;135
19;Kėdainių rajono;54;54 - Dotnuvėlės;804;370;434
20;Klaipėdos miesto;1;1 - Gimnazijos;2908;1268;1640
20;Klaipėdos miesto;4;4 - Danės;1036;439;597
20;Klaipėdos miesto;5;5 - Eglės;1430;599;831
20;Klaipėdos miesto;6;6 - Dviračių Treko;2201;920;1281
20;Klaipėdos miesto;7;7 - Kretingos;1880;859;1021
20;Klaipėdos miesto;8;8 - Šviesos;2517;1105;1412
20;Klaipėdos miesto;9;9 - Muzikos Centro;1125;492;633
20;Klaipėdos miesto;10;10 - Žaliakalnio;977;418;559
20;Klaipėdos miesto;11;11 - Saulutės;4047;1837;2210
20;Klaipėdos miesto;13;13 - Strėvos;2683;1176;1507
20;Klaipėdos miesto;14;14 - Sulupės;2229;979;1250
20;Klaipėdos miesto;15;15 - Tauralaukio;4189;1931;2258
20;Klaipėdos miesto;16;16 - Baltikalnio;1310;561;749
20;Klaipėdos miesto;17;17 - Saulėtekio;2326;1153;1173
20;Klaipėdos miesto;18;18 - Šatrijos;1038;497;541
20;Klaipėdos miesto;19;19 - Vilties;1550;637;913
20;Klaipėdos miesto;20;20 - Pingvinuko;1450;626;824
20;Klaipėdos miesto;21;21 - Klaipėdos Vandens;3578;1554;2024
20;Klaipėdos miesto;22;22 - Rumpiškių;1314;538;776
20;Klaipėdos miesto;23;23 - Aitvaro;2511;1058;1453
20;Klaipėdos miesto;25;25 - Šilojų;3659;1673;1986
20;Klaipėdos miesto;26;26 - Brigantinos;1571;672;899
20;Klaipėdos miesto;27;27 - Draugystės;2580;1093;1487
20;Klaipėdos miesto;29;29 - Švyturio;1642;726;916
20;Klaipėdos miesto;30;30 - Olimpijos;1605;714;891
20;Klaipėdos miesto;32;32 - Dainavos;2475;1044;1431
20;Klaipėdos miesto;33;33 - Aušros;927;386;541
20;Klaipėdos miesto;35;35 - Nykštuko;1736;721;1015
20;Klaipėdos miesto;36;36 - Debreceno;2154;929;1225
20;Klaipėdos miesto;37;37 - Gedminų;2181;928;1253
20;Klaipėdos miesto;38;38 - Vėtrungės;1954;848;1106
20;Klaipėdos miesto;39;39 - Žilvičio;1365;575;790
20;Klaipėdos miesto;40;40 - Pamario;3319;1450;1869
20;Klaipėdos miesto;43;43 - Rambyno;2585;1168;1417
20;Klaipėdos miesto;45;45 - Menų mokyklos;1758;754;1004
20;Klaipėdos miesto;47;47 - Versmės;3147;1311;1836
20;Klaipėdos miesto;48;48 - Vakarų;3291;1412;1879
20;Klaipėdos miesto;49;49 - Aukuro;2748;1181;1567
20;Klaipėdos miesto;50;50 - Smiltelės;2993;1298;1695
20;Klaipėdos miesto;51;51 - Alksnynės;3045;1325;1720
20;Klaipėdos miesto;52;52 - Baltijos;1604;741;863
20;Klaipėdos miesto;54;54 - Želmenėlio;2686;1194;1492
20;Klaipėdos miesto;55;55 - Brožynų;3016;1347;1669
20;Klaipėdos miesto;56;56 - Laukininkai;3496;1551;1945
20;Klaipėdos miesto;57;57 - Budelkiemio;3206;1424;1782
20;Klaipėdos miesto;58;58 - Berželio;3409;1493;1916
20;Klaipėdos miesto;59;59 - Girulių;572;280;292
20;Klaipėdos miesto;60;60 - Molo;877;434;443
20;Klaipėdos miesto;63;63 - Prekybos uosto;2580;1049;1531
20;Klaipėdos miesto;64;64 - S. Daukanto;882;399;483
20;Klaipėdos miesto;65;65 - Kuršių;1528;651;877
20;Klaipėdos miesto;66;66 - Politechnikos;1249;596;653
20;Klaipėdos miesto;67;67 - Volungėlės;2423;1113;1310
20;Klaipėdos miesto;68;68 - Bandužių;3445;1574;1871
21;Klaipėdos rajono;1;1 - Gargždų;3259;1416;1843
21;Klaipėdos rajono;2;2 - Gargždų;3697;1790;1907
21;Klaipėdos rajono;3;3 - Gargždų;2971;1328;1643
21;Klaipėdos rajono;4;4 - Gargždų;1923;847;1076
21;Klaipėdos rajono;5;5 - Endriejavo;947;485;462
21;Klaipėdos rajono;6;6 - Judrėnų;472;230;242
21;Klaipėdos rajono;7;7 - Žadeikių;213;95;118
21;Klaipėdos rajono;8;8 - Daukšaičių;297;140;157
21;Klaipėdos rajono;9;9 - Pėžaičių;500;258;242
21;Klaipėdos rajono;10;10 - Šalpėnų;294;154;140
21;Klaipėdos rajono;11;11 - Veiviržėnų;1070;522;548
21;Klaipėdos rajono;12;12 - Girininkų;439;232;207
21;Klaipėdos rajono;13;13 - Lapių;522;273;249
21;Klaipėdos rajono;14;14 - Tilvikų;187;106;81
21;Klaipėdos rajono;15;15 - Vėžaičių;2394;1186;1208
21;Klaipėdos rajono;16;16 - Priekulės;2154;1039;1115
21;Klaipėdos rajono;17;17 - Agluonėnų;924;471;453
21;Klaipėdos rajono;18;18 - Dovilų;3429;1742;1687
21;Klaipėdos rajono;19;19 - Ketvergių;2129;1121;1008
21;Klaipėdos rajono;20;20 - Šiūparių;691;347;344
21;Klaipėdos rajono;21;21 - Dauparų;1670;835;835
21;Klaipėdos rajono;22;22 - Kvietinių;910;473;437
21;Klaipėdos rajono;23;23 - Girkalių;643;314;329
21;Klaipėdos rajono;24;24 - Kretingalės;1330;664;666
21;Klaipėdos rajono;25;25 - Plikių;977;500;477
21;Klaipėdos rajono;26;26 - Drevernos;537;275;262
21;Klaipėdos rajono;27;27 - Kalotės;2048;1044;1004
21;Klaipėdos rajono;28;28 - Venckų;547;273;274
21;Klaipėdos rajono;29;29 - Jakų;1428;733;695
21;Klaipėdos rajono;30;30 - Slengių;3523;1832;1691
21;Klaipėdos rajono;31;31 - Dituvos;3717;1924;1793
21;Klaipėdos rajono;32;32 - Karklės;1433;717;716
21;Klaipėdos rajono;33;33 - Gindulių;2248;1154;1094
21;Klaipėdos rajono;34;34 - Trušelių;3836;2016;1820
22;Kretingos rajono;1;1 - Parko;1566;678;888
22;Kretingos rajono;2;2 - M.Daujoto;1755;794;961
22;Kretingos rajono;3;3 - J.Pabrėžos;1757;800;957
22;Kretingos rajono;4;4 - Vytauto;1813;872;941
22;Kretingos rajono;5;5 - S.Daukanto;2072;980;1092
22;Kretingos rajono;6;6 - Kretingos;1845;759;1086
22;Kretingos rajono;7;7 - Salantų;1105;468;637
22;Kretingos rajono;8;8 - Darbėnų;1295;617;678
22;Kretingos rajono;9;9 - Lazdininkų;306;149;157
22;Kretingos rajono;10;10 - Kašučių;327;164;163
22;Kretingos rajono;11;11 - Kumpikų;200;104;96
22;Kretingos rajono;12;12 - Grūšlaukės;362;178;184
22;Kretingos rajono;13;13 - Mančių;100;52;48
22;Kretingos rajono;14;14 - Laukžemės;369;185;184
22;Kretingos rajono;15;15 - Piliakalnio;284;141;143
22;Kretingos rajono;16;16 - Žvainių;314;157;157
22;Kretingos rajono;17;17 - Laivių;307;163;144
22;Kretingos rajono;18;18 - Juodupėnų;239;126;113
22;Kretingos rajono;19;19 - Erlėnų;306;160;146
22;Kretingos rajono;20;20 - Kalnalio;179;101;78
22;Kretingos rajono;21;21 - Kartenos;980;450;530
22;Kretingos rajono;22;22 - Kalniškių;231;109;122
22;Kretingos rajono;23;23 - Kurmaičių;690;343;347
22;Kretingos rajono;24;24 - Dvaro;1292;621;671
22;Kretingos rajono;25;25 - Padvarių;268;133;135
22;Kretingos rajono;26;26 - Kretingsodžio;1382;683;699
22;Kretingos rajono;27;27 - Rūdaičių;654;311;343
22;Kretingos rajono;28;28 - Vydmantų;1974;952;1022
22;Kretingos rajono;29;29 - Kūlupėnų;991;487;504
22;Kretingos rajono;30;30 - Nasrėnų;139;68;71
22;Kretingos rajono;31;31 - Baublių;447;218;229
22;Kretingos rajono;32;32 - Budrių;208;104;104
22;Kretingos rajono;34;34 - Dupulčių;1133;564;569
22;Kretingos rajono;35;35 - Raguviškių;344;172;172
22;Kretingos rajono;36;36 - Rubulių;558;285;273
22;Kretingos rajono;37;37 - Jokūbavo;326;154;172
22;Kretingos rajono;38;38 - Valėnų;215;108;107
22;Kretingos rajono;39;39 - Leliūnų;156;78;78
22;Kretingos rajono;40;40 - Bajorų;1356;662;694
22;Kretingos rajono;41;41 - M.Tiškevičiūtės;1569;668;901
23;Kupiškio rajono;1;1 - Adomynės;328;174;154
23;Kupiškio rajono;2;2 - Alizavos;417;210;207
23;Kupiškio rajono;3;3 - Antašavos;433;220;213
23;Kupiškio rajono;4;4 - Aukštupėnų;650;324;326
23;Kupiškio rajono;6;6 - Juodpėnų;195;99;96
23;Kupiškio rajono;7;7 - Račiupėnų;2121;904;1217
23;Kupiškio rajono;8;8 - Kupos;1515;614;901
23;Kupiškio rajono;9;9 - Senamiesčio;1479;663;816
23;Kupiškio rajono;11;11 - Lukonių;342;177;165
23;Kupiškio rajono;13;13 - Naivių;235;113;122
23;Kupiškio rajono;14;14 - Noriūnų;1077;499;578
23;Kupiškio rajono;15;15 - Paketurių;441;228;213
23;Kupiškio rajono;16;16 - Rudilių;347;172;175
23;Kupiškio rajono;17;17 - Salamiesčio;425;204;221
23;Kupiškio rajono;18;18 - Skapiškio;834;425;409
23;Kupiškio rajono;20;20 - Subačiaus;1141;533;608
23;Kupiškio rajono;21;21 - Šepetos;803;368;435
23;Kupiškio rajono;22;22 - Šimonių;545;255;290
23;Kupiškio rajono;23;23 - Virbališkių;218;106;112
23;Kupiškio rajono;24;24 - Žaidelių;292;155;137
24;Lazdijų rajono;1;1 - Avižienių;516;254;262
24;Lazdijų rajono;4;4 - Būdviečio;264;138;126
24;Lazdijų rajono;6;6 - Kapčiamiesčio;966;513;453
24;Lazdijų rajono;7;7 - A. Kirsnos;447;217;230
24;Lazdijų rajono;8;8 - Kirsnos;295;141;154
24;Lazdijų rajono;9;9 - Krikštonių;247;128;119
24;Lazdijų rajono;10;10 - Krosnos;632;312;320
24;Lazdijų rajono;12;12 - Kučiūnų;507;273;234
24;Lazdijų rajono;14;14 - Lazdijų;2265;1092;1173
24;Lazdijų rajono;15;15 - Metelių;221;108;113
24;Lazdijų rajono;17;17 - Noragėlių;220;114;106
24;Lazdijų rajono;19;19 - Rudaminos;314;150;164
24;Lazdijų rajono;20;20 - Seiliūnų;235;122;113
24;Lazdijų rajono;21;21 - Seirijų;1172;575;597
24;Lazdijų rajono;22;22 - Stebulių;259;127;132
24;Lazdijų rajono;23;23 - Šeštokų;825;401;424
24;Lazdijų rajono;24;24 - Šventežerio;616;319;297
24;Lazdijų rajono;25;25 - Teizų;392;208;184
24;Lazdijų rajono;26;26 - Verstaminų;294;158;136
24;Lazdijų rajono;27;27 - Veisiejų;2084;1006;1078
24;Lazdijų rajono;30;30 - Dzūkų;2424;1075;1349
24;Lazdijų rajono;33;33 - Varnėnų;327;182;145
25;Marijampolės;1;1 - Kvietiškio;2723;1212;1511
25;Marijampolės;2;2 - Narto;1810;843;967
25;Marijampolės;3;3 - Laikštės;1837;878;959
25;Marijampolės;4;4 - Tarpučių;3672;1728;1944
25;Marijampolės;5;5 - Uosupio;2004;864;1140
25;Marijampolės;6;6 - Mokolų;2617;1133;1484
25;Marijampolės;7;7 - Degučių;2768;1156;1612
25;Marijampolės;8;8 - Suvalkiečių;1849;821;1028
25;Marijampolės;9;9 - Šaulių;2005;839;1166
25;Marijampolės;10;10 - Kauno;1799;743;1056
25;Marijampolės;11;11 - Dariaus ir Girėno;2147;879;1268
25;Marijampolės;12;12 - Beržų;1207;487;720
25;Marijampolės;13;13 - Armino;862;383;479
25;Marijampolės;15;15 - Centro;1867;830;1037
25;Marijampolės;16;16 - Mokolų kaimo;1343;649;694
25;Marijampolės;17;17 - Šunskų;734;386;348
25;Marijampolės;18;18 - Sasnavos;870;428;442
25;Marijampolės;19;19 - Puskelnių;819;410;409
25;Marijampolės;21;21 - Baraginės;1192;584;608
25;Marijampolės;22;22 - Patašinės;1008;501;507
25;Marijampolės;23;23 - Igliškėlių;339;182;157
25;Marijampolės;24;24 - Igliaukos;862;422;440
25;Marijampolės;25;25 - Šventragio;308;153;155
25;Marijampolės;26;26 - Gudelių;473;230;243
25;Marijampolės;27;27 - Daugirdų;187;105;82
25;Marijampolės;28;28 - Daukšių;189;99;90
25;Marijampolės;29;29 - Padovinio;466;244;222
25;Marijampolės;31;31 - Želsvos;887;419;468
25;Marijampolės;32;32 - Liudvinavo;1647;835;812
25;Marijampolės;33;33 - Netičkampio;1017;519;498
25;Marijampolės;34;34 - Valavičių;498;263;235
25;Marijampolės;35;35 - Balsupių;799;410;389
25;Marijampolės;36;36 - Varnupių;159;83;76
25;Marijampolės;38;38 - Meškučių;919;454;465
25;Marijampolės;40;40 - Tautkaičių;572;288;284
25;Marijampolės;41;41 - Gavaltuvos;280;139;141
26;Mažeikių rajono;1;1 - M. Račkausko;2087;974;1113
26;Mažeikių rajono;2;2 - Senamiesčio;2586;1226;1360
26;Mažeikių rajono;4;4 - Gabijos;2857;1205;1652
26;Mažeikių rajono;6;6 - Reivyčių;2296;1059;1237
26;Mažeikių rajono;7;7 - Pavasario;3298;1457;1841
26;Mažeikių rajono;8;8 - Naftininkų;3087;1289;1798
26;Mažeikių rajono;9;9 - Pavenčių;1956;851;1105
26;Mažeikių rajono;10;10 - Sodų;3029;1286;1743
26;Mažeikių rajono;11;11 - Kalnėnų;3062;1371;1691
26;Mažeikių rajono;12;12 - Ventos;3338;1525;1813
26;Mažeikių rajono;13;13 - Sedos;1386;665;721
26;Mažeikių rajono;14;14 - Žemalės;436;218;218
26;Mažeikių rajono;15;15 - Šerkšnėnų;428;208;220
26;Mažeikių rajono;16;16 - Plinkšių;506;266;240
26;Mažeikių rajono;17;17 - Tirkšlių;1980;990;990
26;Mažeikių rajono;18;18 - Balėnų;623;324;299
26;Mažeikių rajono;19;19 - Užlieknės;396;202;194
26;Mažeikių rajono;20;20 - Buknaičių;295;145;150
26;Mažeikių rajono;21;21 - Leckavos;270;138;132
26;Mažeikių rajono;22;22 - Auksūdžio;299;150;149
26;Mažeikių rajono;23;23 - Dagių;191;101;90
26;Mažeikių rajono;24;24 - Renavo;374;181;193
26;Mažeikių rajono;25;25 - Pikelių;449;245;204
26;Mažeikių rajono;27;27 - Ukrinų;427;213;214
26;Mažeikių rajono;28;28 - Židikų;628;317;311
26;Mažeikių rajono;29;29 - Urvikių;389;195;194
26;Mažeikių rajono;30;30 - Bugenių;919;482;437
26;Mažeikių rajono;31;31 - Krakių;860;443;417
26;Mažeikių rajono;32;32 - Purvėnų;406;208;198
26;Mažeikių rajono;33;33 - Laižuvos;345;178;167
26;Mažeikių rajono;36;36 - Kapėnų;333;169;164
26;Mažeikių rajono;37;37 - Palnosų;630;306;324
26;Mažeikių rajono;38;38 - Viekšnių;2461;1165;1296
27;Molėtų rajono;1;1 - Alantos;668;331;337
27;Molėtų rajono;2;2 - Žalvarių;368;208;160
27;Molėtų rajono;3;3 - Balninkų;303;161;142
27;Molėtų rajono;4;4 - Bekupės;333;171;162
27;Molėtų rajono;5;5 - Bijutiškio;288;155;133
27;Molėtų rajono;6;6 - Čiulėnų;754;389;365
27;Molėtų rajono;7;7 - Dapkūniškių;200;109;91
27;Molėtų rajono;8;8 - Dubingių;378;208;170
27;Molėtų rajono;9;9 - Giedraičių;767;402;365
27;Molėtų rajono;10;10 - Girsteitiškio;214;106;108
27;Molėtų rajono;11;11 - Inturkės;670;369;301
27;Molėtų rajono;12;12 - Joniškio;681;356;325
27;Molėtų rajono;13;13 - Miežonių;281;145;136
27;Molėtų rajono;14;14 - Levaniškių;341;161;180
27;Molėtų rajono;15;15 - Arnionių;180;90;90
27;Molėtų rajono;16;16 - Mindūnų;403;216;187
27;Molėtų rajono;17;17 - Siesarties;2974;1337;1637
27;Molėtų rajono;18;18 - Liepų;2871;1280;1591
27;Molėtų rajono;19;19 - Naujasodžio;545;257;288
27;Molėtų rajono;20;20 - Skudutiškio;305;174;131
27;Molėtų rajono;21;21 - Suginčių;430;223;207
27;Molėtų rajono;22;22 - Videniškių;524;274;250
27;Molėtų rajono;23;23 - Vorėnų;238;126;112
27;Molėtų rajono;24;24 - Verbiškių;305;142;163
28;Neringos;1;1 - Kopų;2337;1230;1107
28;Neringos;2;2 - Smėlio;1555;897;658
28;Neringos;3;3 - Pušų;721;413;308
29;Pagėgių;1;1 - Pagėgių;1421;617;804
29;Pagėgių;2;2 - Panemunės;211;101;110
29;Pagėgių;3;3 - Kentrių;175;92;83
29;Pagėgių;4;4 - Natkiškių;559;281;278
29;Pagėgių;5;5 - Pagėgių kaimiškoji;502;243;259
29;Pagėgių;6;6 - Piktupėnų;431;221;210
29;Pagėgių;7;7 - Stoniškių;939;452;487
29;Pagėgių;8;8 - Šilgalių;451;227;224
29;Pagėgių;9;9 - Rambyno;724;370;354
29;Pagėgių;10;10 - Vilkyškių;613;284;329
29;Pagėgių;11;11 - Žukų;449;220;229
30;Pakruojo rajono;1;1 - Balsių;613;289;324
30;Pakruojo rajono;2;2 - Bardiškių;357;185;172
30;Pakruojo rajono;3;3 - Degesių;248;130;118
30;Pakruojo rajono;4;4 - Degučių;203;100;103
30;Pakruojo rajono;5;5 - Draudelių;120;59;61
30;Pakruojo rajono;6;6 - Dvariškių;240;116;124
30;Pakruojo rajono;7;7 - Gačionių;179;83;96
30;Pakruojo rajono;9;9 - Guostagalio;588;304;284
30;Pakruojo rajono;10;10 - Grikpėdžių;238;131;107
30;Pakruojo rajono;11;11 - Klovainių;584;285;299
30;Pakruojo rajono;13;13 - Kauksnųjų;137;67;70
30;Pakruojo rajono;14;14 - Laipuškių;151;76;75
30;Pakruojo rajono;15;15 - Linksmučių;246;119;127
30;Pakruojo rajono;16;16 - Linkuvos;1547;760;787
30;Pakruojo rajono;17;17 - Linų;270;141;129
30;Pakruojo rajono;18;18 - Lygumų;479;227;252
30;Pakruojo rajono;19;19 - Mažeikonių;713;352;361
30;Pakruojo rajono;20;20 - Mikniūnų;273;141;132
30;Pakruojo rajono;21;21 - Medikonių;245;127;118
30;Pakruojo rajono;22;22 - Mikoliškio;150;73;77
30;Pakruojo rajono;23;23 - Naujamiesčio;2436;1053;1383
30;Pakruojo rajono;24;24 - Pakruojo;1661;715;946
30;Pakruojo rajono;25;25 - Pamūšio;226;106;120
30;Pakruojo rajono;26;26 - Pašvitinio;417;205;212
30;Pakruojo rajono;28;28 - Preičiūnų;188;99;89
30;Pakruojo rajono;30;30 - Plaučiškių;237;114;123
30;Pakruojo rajono;31;31 - Rimkūnų;135;67;68
30;Pakruojo rajono;32;32 - Rozalimo;677;312;365
30;Pakruojo rajono;33;33 - Stačiūnų;243;125;118
30;Pakruojo rajono;35;35 - Šukionių;272;141;131
30;Pakruojo rajono;36;36 - Triškonių;277;144;133
30;Pakruojo rajono;37;37 - Ūdekų;241;121;120
30;Pakruojo rajono;38;38 - Žeimelio;716;345;371
30;Pakruojo rajono;39;39 - Žvirblonių;267;134;133
31;Palangos miesto;1;1 - Kaštonų;1480;697;783
31;Palangos miesto;2;2 - Ateities;3292;1460;1832
31;Palangos miesto;3;3 - Saulės;4002;1679;2323
31;Palangos miesto;4;4 - Vilniaus;1534;723;811
31;Palangos miesto;5;5 - Aikštės;3272;1394;1878
31;Palangos miesto;7;7 - Jūros;1675;816;859
32;Panevėžio miesto;1;1 - Geležinkelio;2917;1356;1561
32;Panevėžio miesto;2;2 - Rožių;3661;1726;1935
32;Panevėžio miesto;3;3 - Šiaulių;2452;1137;1315
32;Panevėžio miesto;4;4 - Vienybės;2107;904;1203
32;Panevėžio miesto;5;5 - Šermukšnių;2500;1054;1446
32;Panevėžio miesto;6;6 - V. Žemkalnio;1682;693;989
32;Panevėžio miesto;7;7 - J.Balčikonio;1733;769;964
32;Panevėžio miesto;8;8 - Laisvės;1721;725;996
32;Panevėžio miesto;9;9 - Poliklinikos;1942;776;1166
32;Panevėžio miesto;10;10 - Menų mokyklos;2362;1056;1306
32;Panevėžio miesto;11;11 - Danutės;1849;764;1085
32;Panevėžio miesto;12;12 - Tulpių;2258;938;1320
32;Panevėžio miesto;13;13 - Pilėnai;3146;1307;1839
32;Panevėžio miesto;14;14 - Nemuno;4450;2064;2386
32;Panevėžio miesto;15;15 - Žvaigždžių;3371;1403;1968
32;Panevėžio miesto;16;16 - Šermuto;3360;1432;1928
32;Panevėžio miesto;17;17 - Parko;2447;998;1449
32;Panevėžio miesto;18;18 - Dariaus ir Girėno;2749;1164;1585
32;Panevėžio miesto;19;19 - A. Lipniūno;4261;1844;2417
32;Panevėžio miesto;21;21 - Žvaigždutės;2426;959;1467
32;Panevėžio miesto;22;22 - Statybininkų;2393;953;1440
32;Panevėžio miesto;23;23 - Kniaudiškių;3741;1660;2081
32;Panevėžio miesto;24;24 - Vandentiekio;2026;903;1123
32;Panevėžio miesto;25;25 - Ukmergės;2037;803;1234
32;Panevėžio miesto;26;26 - J.Miltinio;2375;959;1416
32;Panevėžio miesto;27;27 - Staniūnų;1922;846;1076
32;Panevėžio miesto;28;28 - Beržų;3182;1388;1794
32;Panevėžio miesto;29;29 - Ramygalos;1523;638;885
33;Panevėžio rajono;1;1 - Geležių;438;220;218
33;Panevėžio rajono;2;2 - Tiltagalių;547;283;264
33;Panevėžio rajono;3;3 - Karsakiškio;740;391;349
33;Panevėžio rajono;4;4 - Paliūniškio;552;294;258
33;Panevėžio rajono;5;5 - Piniavos;1788;903;885
33;Panevėžio rajono;6;6 - Bernatonių;1431;737;694
33;Panevėžio rajono;7;7 - Paįstrio;1187;598;589
33;Panevėžio rajono;8;8 - Daukniūnų;563;283;280
33;Panevėžio rajono;9;9 - Krekenavos;1679;830;849
33;Panevėžio rajono;11;11 - Žibartonių;659;333;326
33;Panevėžio rajono;12;12 - Naujarodžių;299;151;148
33;Panevėžio rajono;13;13 - Linkaučių;268;134;134
33;Panevėžio rajono;14;14 - Upytės;644;306;338
33;Panevėžio rajono;15;15 - Ėriškių;467;228;239
33;Panevėžio rajono;16;16 - Liberiškio;433;223;210
33;Panevėžio rajono;17;17 - Berniūnų;511;259;252
33;Panevėžio rajono;18;18 - Naujamiesčio;1117;549;568
33;Panevėžio rajono;19;19 - Gustonių;458;231;227
33;Panevėžio rajono;20;20 - Smilgių;487;241;246
33;Panevėžio rajono;21;21 - Sujėtų;248;132;116
33;Panevėžio rajono;22;22 - Perekšlių;438;208;230
33;Panevėžio rajono;23;23 - Uliūnų;532;278;254
33;Panevėžio rajono;24;24 - Ramygalos;1688;818;870
33;Panevėžio rajono;25;25 - Daniūnų;287;150;137
33;Panevėžio rajono;26;26 - Raguvos;839;406;433
33;Panevėžio rajono;27;27 - Šilų;225;120;105
33;Panevėžio rajono;28;28 - Miežiškių;557;278;279
33;Panevėžio rajono;29;29 - Nevėžio;479;243;236
33;Panevėžio rajono;30;30 - Trakiškio;729;394;335
33;Panevėžio rajono;31;31 - Paežerio;924;463;461
33;Panevėžio rajono;32;32 - Šilagalio;625;300;325
33;Panevėžio rajono;33;33 - Dembavos;2394;1141;1253
33;Panevėžio rajono;34;34 - Velžio;2464;1197;1267
33;Panevėžio rajono;35;35 - Liūdynės;552;266;286
33;Panevėžio rajono;36;36 - Katinų;478;235;243
33;Panevėžio rajono;37;37 - Pažagienių;637;293;344
33;Panevėžio rajono;38;38 - Vadoklių;711;360;351
33;Panevėžio rajono;39;39 - Jotainių;577;280;297
33;Panevėžio rajono;42;42 - Molainių;1017;514;503
33;Panevėžio rajono;44;44 - Skaistgirių;332;176;156
34;Pasvalio rajono;1;1 - Joniškėlio;1345;652;693
34;Pasvalio rajono;2;2 - P.Vileišio;1928;799;1129
34;Pasvalio rajono;3;3 - Kalno;2215;1002;1213
34;Pasvalio rajono;4;4 - Vilniaus;1535;681;854
34;Pasvalio rajono;5;5 - Daujėnų;431;224;207
34;Pasvalio rajono;6;6 - Girsūdų;391;190;201
34;Pasvalio rajono;7;7 - Švobiškio;322;166;156
34;Pasvalio rajono;8;8 - Norgėlų;184;91;93
34;Pasvalio rajono;9;9 - Meškalaukio;396;195;201
34;Pasvalio rajono;11;11 - Narteikių;390;195;195
34;Pasvalio rajono;12;12 - Krinčino;545;266;279
34;Pasvalio rajono;13;13 - Gulbinėnų;157;75;82
34;Pasvalio rajono;14;14 - Pajiešmenių;618;302;316
34;Pasvalio rajono;15;15 - Papyvesių;574;280;294
34;Pasvalio rajono;16;16 - Talačkonių;414;204;210
34;Pasvalio rajono;17;17 - Ustukių;714;346;368
34;Pasvalio rajono;18;18 - Valakėlių;316;163;153
34;Pasvalio rajono;19;19 - Pumpėnų;754;381;373
34;Pasvalio rajono;20;20 - Jurgėnų;419;204;215
34;Pasvalio rajono;21;21 - Kriklinių;310;157;153
34;Pasvalio rajono;22;22 - Rinkūnų;263;136;127
34;Pasvalio rajono;23;23 - Pušaloto;573;273;300
34;Pasvalio rajono;24;24 - Mikoliškio;448;216;232
34;Pasvalio rajono;25;25 - Deglėnų;116;59;57
34;Pasvalio rajono;26;26 - Kiemėnų;235;107;128
34;Pasvalio rajono;27;27 - Namišių;325;162;163
34;Pasvalio rajono;28;28 - Raubonių;511;247;264
34;Pasvalio rajono;29;29 - Saločių;904;448;456
34;Pasvalio rajono;31;31 - Žilpamūšio;325;169;156
34;Pasvalio rajono;32;32 - Grūžių;294;144;150
34;Pasvalio rajono;33;33 - Nairių;256;136;120
34;Pasvalio rajono;34;34 - Tetirvinų;459;228;231
34;Pasvalio rajono;35;35 - Vaškų;648;323;325
35;Plungės rajono;1;1 - Birutės;1621;741;880
35;Plungės rajono;2;2 - Dariaus ir Girėno;1366;604;762
35;Plungės rajono;3;3 - A. Jucio;2668;1117;1551
35;Plungės rajono;4;4 - Laisvės;2331;1097;1234
35;Plungės rajono;5;5 - V.Mačernio;2334;997;1337
35;Plungės rajono;6;6 - Senamiesčio;1504;671;833
35;Plungės rajono;7;7 - A.Vaišvilos;2110;889;1221
35;Plungės rajono;8;8 - Aleksandravo;301;156;145
35;Plungės rajono;9;9 - Alsėdžių;879;444;435
35;Plungės rajono;11;11 - Didvyčių;399;209;190
35;Plungės rajono;12;12 - Gegrėnų;398;213;185
35;Plungės rajono;14;14 - Gintališkės;303;160;143
35;Plungės rajono;15;15 - Glaudžių;854;418;436
35;Plungės rajono;16;16 - Grumblių;365;188;177
35;Plungės rajono;17;17 - Karklėnų;586;312;274
35;Plungės rajono;18;18 - Kontaučių;460;244;216
35;Plungės rajono;19;19 - Kulių;818;406;412
35;Plungės rajono;21;21 - Milašaičių;302;155;147
35;Plungės rajono;23;23 - Narvaišių;601;307;294
35;Plungės rajono;24;24 - Nausodžio;1574;765;809
35;Plungės rajono;26;26 - Platelių;1030;509;521
35;Plungės rajono;29;29 - Stalgėnų;421;221;200
35;Plungės rajono;30;30 - Stanelių;536;273;263
35;Plungės rajono;31;31 - Šateikių;819;418;401
35;Plungės rajono;32;32 - Truikių;691;353;338
35;Plungės rajono;34;34 - Žemaičių Kalvarijos;940;451;489
35;Plungės rajono;35;35 - Žlibinų;514;258;256
35;Plungės rajono;37;37 - Prūsalių;1173;595;578
36;Prienų rajono;1;1 - Dariaus ir Girėno;2293;1067;1226
36;Prienų rajono;2;2 - J.Basanavičiaus;2116;929;1187
36;Prienų rajono;3;3 - Kęstučio;1189;517;672
36;Prienų rajono;4;4 - Statybininkų;1853;753;1100
36;Prienų rajono;5;5 - Žemaitkiemio;472;239;233
36;Prienų rajono;7;7 - Išlaužo;1172;586;586
36;Prienų rajono;8;8 - Naujosios Ūtos;342;169;173
36;Prienų rajono;9;9 - Jiestrakio;344;165;179
36;Prienų rajono;10;10 - Klebiškio;549;292;257
36;Prienų rajono;11;11 - Šilavoto;505;241;264
36;Prienų rajono;13;13 - Skriaudžių;1135;572;563
36;Prienų rajono;14;14 - Juodbūdžio;443;224;219
36;Prienų rajono;15;15 - Veiverių;1517;732;785
36;Prienų rajono;16;16 - Balbieriškio;1876;931;945
36;Prienų rajono;17;17 - Jiezno;1419;659;760
36;Prienų rajono;19;19 - Kašonių;454;240;214
36;Prienų rajono;20;20 - Vėžionių;242;132;110
36;Prienų rajono;21;21 - Ašmintos;438;235;203
36;Prienų rajono;22;22 - Strielčių;695;340;355
36;Prienų rajono;29;29 - Pakuonio;823;410;413
36;Prienų rajono;31;31 - Vyšniūnų;541;286;255
36;Prienų rajono;32;32 - Užuguosčio;259;129;130
36;Prienų rajono;33;33 - Pieštuvėnų;389;197;192
36;Prienų rajono;34;34 - Stakliškių;604;291;313
37;Radviliškio rajono;2;2 - Alksniupių;635;308;327
37;Radviliškio rajono;3;3 - Aukštelkų;1032;514;518
37;Radviliškio rajono;4;4 - Baisogalos;1697;775;922
37;Radviliškio rajono;5;5 - Beinoravos;308;155;153
37;Radviliškio rajono;7;7 - Daugėlaičių;549;276;273
37;Radviliškio rajono;10;10 - Grinkiškio;1001;498;503
37;Radviliškio rajono;13;13 - Karčemų;794;383;411
37;Radviliškio rajono;14;14 - Kutiškių;668;330;338
37;Radviliškio rajono;17;17 - Pakiršinio;682;326;356
37;Radviliškio rajono;18;18 - Palonų;351;188;163
37;Radviliškio rajono;20;20 - Pašušvio;536;264;272
37;Radviliškio rajono;21;21 - Pavartyčių;529;273;256
37;Radviliškio rajono;22;22 - Pociūnų;325;181;144
37;Radviliškio rajono;23;23 - Pociūnėlių;443;228;215
37;Radviliškio rajono;25;25 - Vaižganto;2504;1139;1365
37;Radviliškio rajono;27;27 - Kudirkos;2488;1008;1480
37;Radviliškio rajono;28;28 - Rūmų;2271;1000;1271
37;Radviliškio rajono;29;29 - Lizdeikos;2563;1227;1336
37;Radviliškio rajono;30;30 - Raudondvario;687;339;348
37;Radviliškio rajono;31;31 - Sidabravo;1085;545;540
37;Radviliškio rajono;32;32 - Skėmių;367;170;197
37;Radviliškio rajono;33;33 - Šaukoto;617;311;306
37;Radviliškio rajono;34;34 - Šeduvos;2046;917;1129
37;Radviliškio rajono;36;36 - Šiaulėnų;821;413;408
37;Radviliškio rajono;37;37 - Šniūraičių;463;231;232
37;Radviliškio rajono;38;38 - Tyrulių;552;286;266
37;Radviliškio rajono;41;41 - Vėriškių;471;251;220
37;Radviliškio rajono;44;44 - Eibariškių;2462;1086;1376
38;Raseinių rajono;1;1 - Prabaudos;2050;951;1099
38;Raseinių rajono;2;2 - Stonų;2210;974;1236
38;Raseinių rajono;3;3 - Centro;1675;667;1008
38;Raseinių rajono;4;4 - Pramonės;2129;915;1214
38;Raseinių rajono;5;5 - Kalnujų;497;240;257
38;Raseinių rajono;6;6 - Pašaltuonio;170;95;75
38;Raseinių rajono;7;7 - Sujainių;909;459;450
38;Raseinių rajono;8;8 - Slabados;339;178;161
38;Raseinių rajono;9;9 - Viduklės;1761;844;917
38;Raseinių rajono;10;10 - Paupio;194;101;93
38;Raseinių rajono;11;11 - Pryšmančių;487;243;244
38;Raseinių rajono;12;12 - Nemakščių;944;459;485
38;Raseinių rajono;13;13 - Kryžkalnio;361;166;195
38;Raseinių rajono;14;14 - Ariogalos;1278;582;696
38;Raseinių rajono;15;15 - Šarkių;298;158;140
38;Raseinių rajono;16;16 - Gėluvos;363;189;174
38;Raseinių rajono;17;17 - Dainavos;189;96;93
38;Raseinių rajono;18;18 - Butkiškės;386;194;192
38;Raseinių rajono;19;19 - Verėduvos;331;171;160
38;Raseinių rajono;20;20 - Milašaičių;254;134;120
38;Raseinių rajono;21;21 - Paliepių;305;156;149
38;Raseinių rajono;22;22 - Pramedžiavos;394;193;201
38;Raseinių rajono;23;23 - Girkalnio;764;358;406
38;Raseinių rajono;24;24 - Požėčių;355;170;185
38;Raseinių rajono;26;26 - Betygalos;388;191;197
38;Raseinių rajono;27;27 - Berteškių;320;159;161
38;Raseinių rajono;28;28 - Ilgižių;455;237;218
38;Raseinių rajono;30;30 - Kaulakių;451;218;233
38;Raseinių rajono;31;31 - Skirmantiškės;283;136;147
38;Raseinių rajono;32;32 - Vosiliškio;307;163;144
38;Raseinių rajono;33;33 - Šiluvos;595;271;324
38;Raseinių rajono;34;34 - Lyduvėnų;208;104;104
38;Raseinių rajono;35;35 - Katauskių;384;185;199
38;Raseinių rajono;36;36 - Žaiginio;397;197;200
38;Raseinių rajono;37;37 - Ramonų;349;167;182
38;Raseinių rajono;38;38 - Gruzdiškės;438;224;214
38;Raseinių rajono;39;39 - Norgėlų;496;230;266
38;Raseinių rajono;40;40 - Lenkelių;134;70;64
38;Raseinių rajono;41;41 - Gabšių;446;206;240
38;Raseinių rajono;43;43 - Alėjų;162;74;88
38;Raseinių rajono;44;44 - Gervinės;146;70;76
38;Raseinių rajono;45;45 - Melioratorių;1182;526;656
38;Raseinių rajono;46;46 - Didžiulių;231;118;113
39;Rietavo;1;1 - Daugėdų;283;145;138
39;Rietavo;3;3 - Labardžių;247;126;121
39;Rietavo;4;4 - Medingėnų;376;185;191
39;Rietavo;5;5 - Pelaičių;569;296;273
39;Rietavo;6;6 - Rietavo;1517;723;794
39;Rietavo;7;7 - Sauslaukio;1152;557;595
39;Rietavo;8;8 - Tverų;911;475;436
39;Rietavo;9;9 - Gimnazijos;1091;497;594
40;Rokiškio rajono;1;1 - J.Tumo-Vaižganto;1734;736;998
40;Rokiškio rajono;2;2 - Senamiesčio;2176;1045;1131
40;Rokiškio rajono;3;3 - Mikrorajono;1489;597;892
40;Rokiškio rajono;4;4 - J.Tūbelio;2283;922;1361
40;Rokiškio rajono;5;5 - Respublikos;2283;984;1299
40;Rokiškio rajono;6;6 - Bajorų;700;346;354
40;Rokiškio rajono;7;7 - Čedasų;155;78;77
40;Rokiškio rajono;8;8 - Kavoliškio;1300;651;649
40;Rokiškio rajono;9;9 - Skemų;544;294;250
40;Rokiškio rajono;10;10 - Žiobiškio;395;206;189
40;Rokiškio rajono;11;11 - Kazliškio;346;178;168
40;Rokiškio rajono;12;12 - Konstantinavos;113;62;51
40;Rokiškio rajono;13;13 - Obelių;1523;735;788
40;Rokiškio rajono;14;14 - Pandėlio;1106;518;588
40;Rokiškio rajono;15;15 - Juodupės;2077;975;1102
40;Rokiškio rajono;18;18 - Lukštų;213;112;101
40;Rokiškio rajono;19;19 - Jūžintų;609;298;311
40;Rokiškio rajono;20;20 - Laibgalių;519;258;261
40;Rokiškio rajono;21;21 - Sėlynės;246;127;119
40;Rokiškio rajono;22;22 - Kamajų;493;220;273
40;Rokiškio rajono;23;23 - Aukštakalnių;227;122;105
40;Rokiškio rajono;24;24 - Duokiškio;157;85;72
40;Rokiškio rajono;25;25 - Kalvių;248;128;120
40;Rokiškio rajono;26;26 - Salų;267;137;130
40;Rokiškio rajono;27;27 - Kriaunų;381;192;189
40;Rokiškio rajono;28;28 - Lašų;250;133;117
40;Rokiškio rajono;29;29 - Kairelių;201;101;100
40;Rokiškio rajono;30;30 - Pakriaunių;155;74;81
40;Rokiškio rajono;31;31 - Aleksandravėlės;124;52;72
40;Rokiškio rajono;35;35 - Suvainiškio;172;91;81
40;Rokiškio rajono;37;37 - Sriubiškių;204;110;94
40;Rokiškio rajono;38;38 - Lailūnų;212;103;109
40;Rokiškio rajono;40;40 - Panemunio;218;112;106
40;Rokiškio rajono;41;41 - Stoties;599;304;295
40;Rokiškio rajono;42;42 - Panemunėlio;292;159;133
41;Skuodo rajono;1;1 - Skuodo;1770;772;998
41;Skuodo rajono;2;2 - Vilniaus;1688;716;972
41;Skuodo rajono;3;3 - Laisvės;1476;692;784
41;Skuodo rajono;4;4 - Aleksandrijos;471;240;231
41;Skuodo rajono;5;5 - Kaukolikų;306;159;147
41;Skuodo rajono;6;6 - Gėsalų;234;117;117
41;Skuodo rajono;7;7 - Barstyčių;633;322;311
41;Skuodo rajono;9;9 - Ylakių;914;442;472
41;Skuodo rajono;10;10 - Trumplaukės;331;165;166
41;Skuodo rajono;11;11 - Vižančių;290;147;143
41;Skuodo rajono;12;12 - Pašilės;491;246;245
41;Skuodo rajono;14;14 - Lenkimų;646;322;324
41;Skuodo rajono;15;15 - Mosėdžio;1273;634;639
41;Skuodo rajono;16;16 - Šauklių;347;179;168
41;Skuodo rajono;17;17 - Notėnų;266;117;149
41;Skuodo rajono;18;18 - Šliktinės;384;211;173
41;Skuodo rajono;19;19 - Daukšių;425;205;220
41;Skuodo rajono;20;20 - D. Rūšupių;709;361;348
41;Skuodo rajono;21;21 - Luknės;274;146;128
41;Skuodo rajono;22;22 - M. Rūšupių;289;143;146
41;Skuodo rajono;23;23 - Šačių;416;217;199
41;Skuodo rajono;24;24 - Rukų;328;160;168
42;Šakių rajono;1;1 - Žiburio;1354;593;761
42;Šakių rajono;2;2 - Varpo;1714;721;993
42;Šakių rajono;3;3 - Aušros;1125;522;603
42;Šakių rajono;4;4 - Barzdų;376;176;200
42;Šakių rajono;5;5 - Baltrušių;289;147;142
42;Šakių rajono;6;6 - Būblelių;279;139;140
42;Šakių rajono;7;7 - Panovių;372;185;187
42;Šakių rajono;8;8 - Gelgaudiškio;1982;922;1060
42;Šakių rajono;9;9 - Plokščių;636;320;316
42;Šakių rajono;10;10 - Griškabūdžio;1138;563;575
42;Šakių rajono;11;11 - Degutinės;231;121;110
42;Šakių rajono;13;13 - Paluobių;369;193;176
42;Šakių rajono;16;16 - Kidulių;1186;583;603
42;Šakių rajono;17;17 - Voverių;404;204;200
42;Šakių rajono;19;19 - Sudargo;616;329;287
42;Šakių rajono;20;20 - Kriūkų;699;356;343
42;Šakių rajono;21;21 - Gerdžiūnų;539;292;247
42;Šakių rajono;22;22 - Lekėčių;811;380;431
42;Šakių rajono;23;23 - Mikytų;332;166;166
42;Šakių rajono;24;24 - Lukšių;1279;596;683
42;Šakių rajono;25;25 - Liepalotų;503;269;234
42;Šakių rajono;26;26 - Sintautų;905;469;436
42;Šakių rajono;27;27 - Veršių;397;196;201
42;Šakių rajono;28;28 - Keturnaujienos;280;153;127
42;Šakių rajono;29;29 - Žvirgždaičių;406;200;206
42;Šakių rajono;30;30 - Slavikų;477;225;252
42;Šakių rajono;31;31 - Gotlybiškių;411;227;184
42;Šakių rajono;34;34 - Giedručių;746;362;384
42;Šakių rajono;35;35 - Ritinių;340;173;167
42;Šakių rajono;36;36 - Girėnų;778;385;393
42;Šakių rajono;37;37 - Briedžių;399;186;213
42;Šakių rajono;38;38 - Kudirkos Naumiesčio;1217;574;643
43;Šalčininkų rajono;1;1 - Šalčininkų;2060;887;1173
43;Šalčininkų rajono;2;2 - Centrinė miesto;2181;928;1253
43;Šalčininkų rajono;3;3 - Parko;1591;781;810
43;Šalčininkų rajono;4;4 - Šalčininkėlių;765;369;396
43;Šalčininkų rajono;5;5 - Zavišonių;544;261;283
43;Šalčininkų rajono;6;6 - Gerviškių;326;164;162
43;Šalčininkų rajono;7;7 - Tribonių;258;132;126
43;Šalčininkų rajono;8;8 - Sėlų;384;195;189
43;Šalčininkų rajono;9;9 - Čiužiakampio;521;269;252
43;Šalčininkų rajono;10;10 - Butrimonių;631;324;307
43;Šalčininkų rajono;11;11 - Jančiūnų;324;146;178
43;Šalčininkų rajono;12;12 - Eišiškių;1836;823;1013
43;Šalčininkų rajono;13;13 - Jurzdikos;535;273;262
43;Šalčininkų rajono;14;14 - Gornostajiškių;559;283;276
43;Šalčininkų rajono;15;15 - Kalesninkų;768;383;385
43;Šalčininkų rajono;16;16 - Purvėnų;572;284;288
43;Šalčininkų rajono;17;17 - Dainavos;582;289;293
43;Šalčininkų rajono;18;18 - Pabarės;562;273;289
43;Šalčininkų rajono;19;19 - Tetėnų;367;191;176
43;Šalčininkų rajono;20;20 - Jašiūnų;2226;1056;1170
43;Šalčininkų rajono;21;21 - Geležinkelio;466;233;233
43;Šalčininkų rajono;22;22 - Keidžių;284;148;136
43;Šalčininkų rajono;23;23 - Rūdninkų;440;221;219
43;Šalčininkų rajono;24;24 - Baltosios Vokės;956;464;492
43;Šalčininkų rajono;25;25 - Turgelių;937;466;471
43;Šalčininkų rajono;26;26 - Skynimų;347;185;162
43;Šalčininkų rajono;27;27 - Tabariškių;377;192;185
43;Šalčininkų rajono;28;28 - Akmenynės;534;281;253
43;Šalčininkų rajono;29;29 - Poškonių;489;263;226
43;Šalčininkų rajono;30;30 - Dieveniškių;893;456;437
43;Šalčininkų rajono;32;32 - Jurgelionių;203;98;105
43;Šalčininkų rajono;33;33 - Milkūnų;264;126;138
43;Šalčininkų rajono;34;34 - Baušių;365;173;192
43;Šalčininkų rajono;35;35 - Dailidžių;235;122;113
43;Šalčininkų rajono;37;37 - Tausiūnų;168;82;86
44;Šiaulių miesto;2;2 - Medelyno;3915;1844;2071
44;Šiaulių miesto;3;3 - Purienų;1768;780;988
44;Šiaulių miesto;4;4 - J.Basanavičiaus;2214;1005;1209
44;Šiaulių miesto;5;5 - M.K.Čiurlionio;1464;645;819
44;Šiaulių miesto;6;6 - V.Kudirkos;1882;801;1081
44;Šiaulių miesto;8;8 - Vijolių;2213;997;1216
44;Šiaulių miesto;9;9 - Jovaro;2978;1231;1747
44;Šiaulių miesto;10;10 - Parko;1391;556;835
44;Šiaulių miesto;11;11 - Varpo;2065;866;1199
44;Šiaulių miesto;13;13 - J.Janonio;2471;971;1500
44;Šiaulių miesto;15;15 - S.Šalkauskio;2100;834;1266
44;Šiaulių miesto;18;18 - Kražių;1796;731;1065
44;Šiaulių miesto;20;20 - Linkuvos;2182;914;1268
44;Šiaulių miesto;21;21 - Šimšės;2873;1261;1612
44;Šiaulių miesto;22;22 - Zoknių;2051;896;1155
44;Šiaulių miesto;23;23 - Pabalių;1688;818;870
44;Šiaulių miesto;24;24 - Ragainės;1679;751;928
44;Šiaulių miesto;25;25 - K.Donelaičio;2011;944;1067
44;Šiaulių miesto;27;27 - Verduliukų;2702;1139;1563
44;Šiaulių miesto;28;28 - Tilžės;3101;1268;1833
44;Šiaulių miesto;29;29 - Žaliūkių;2102;908;1194
44;Šiaulių miesto;30;30 - Gegužių;2359;965;1394
44;Šiaulių miesto;31;31 - S.Dariaus ir S.Girėno;2146;893;1253
44;Šiaulių miesto;33;33 - Lieporių;2861;1156;1705
44;Šiaulių miesto;34;34 - Beržyno;2090;826;1264
44;Šiaulių miesto;35;35 - Senojo Bokšto;2218;932;1286
44;Šiaulių miesto;36;36 - Dainų;2040;826;1214
44;Šiaulių miesto;37;37 - Aido;1869;783;1086
44;Šiaulių miesto;38;38 - Lyros;2036;854;1182
44;Šiaulių miesto;39;39 - Architektų;1869;801;1068
44;Šiaulių miesto;40;40 - Romuvos;3206;1345;1861
44;Šiaulių miesto;41;41 - Šventupio;3463;1496;1967
44;Šiaulių miesto;42;42 - Gytarių;2881;1273;1608
44;Šiaulių miesto;44;44 - Rėkyvos;4249;2039;2210
45;Šiaulių rajono;1;1 - Ginkūnų;3023;1449;1574
45;Šiaulių rajono;2;2 - Bridų;1576;803;773
45;Šiaulių rajono;3;3 - Vijolių;1040;532;508
45;Šiaulių rajono;4;4 - Voveriškių;944;481;463
45;Šiaulių rajono;5;5 - Gegužių;1341;727;614
45;Šiaulių rajono;6;6 - Aukštelkės;1851;981;870
45;Šiaulių rajono;7;7 - Pakapės;673;359;314
45;Šiaulių rajono;9;9 - Bubių;1095;566;529
45;Šiaulių rajono;10;10 - Gilvyčių;351;198;153
45;Šiaulių rajono;11;11 - Kurtuvėnų;660;360;300
45;Šiaulių rajono;12;12 - Bazilionų;665;361;304
45;Šiaulių rajono;13;13 - Kairių;1774;847;927
45;Šiaulių rajono;14;14 - Šilėnų;424;208;216
45;Šiaulių rajono;15;15 - Žadžiūnų;341;180;161
45;Šiaulių rajono;16;16 - Meškuičių;929;458;471
45;Šiaulių rajono;17;17 - Naisių;565;289;276
45;Šiaulių rajono;18;18 - Gruzdžių;1226;589;637
45;Šiaulių rajono;19;19 - Šiupylių;285;148;137
45;Šiaulių rajono;20;20 - Kužių;1507;753;754
45;Šiaulių rajono;21;21 - Gilaičių;240;116;124
45;Šiaulių rajono;22;22 - Verbūnų;491;247;244
45;Šiaulių rajono;23;23 - Smilgių;221;115;106
45;Šiaulių rajono;24;24 - L. Ivinskio;2103;944;1159
45;Šiaulių rajono;25;25 - Centro;994;385;609
45;Šiaulių rajono;26;26 - Gedimino;2172;1024;1148
45;Šiaulių rajono;27;27 - Pušyno;1396;656;740
45;Šiaulių rajono;28;28 - Pavenčių;1130;535;595
45;Šiaulių rajono;29;29 - Daugėlių;1516;647;869
45;Šiaulių rajono;30;30 - Micaičių;645;335;310
45;Šiaulių rajono;31;31 - Varputėnų;210;116;94
45;Šiaulių rajono;32;32 - Gergždelių;205;103;102
45;Šiaulių rajono;33;33 - Pakumulšių;344;167;177
45;Šiaulių rajono;34;34 - Drąsučių;1002;511;491
45;Šiaulių rajono;35;35 - Romučių;222;132;90
45;Šiaulių rajono;36;36 - Sauginių;388;204;184
45;Šiaulių rajono;37;37 - Raudėnų;470;239;231
45;Šiaulių rajono;38;38 - Dirvonėnų;420;194;226
45;Šiaulių rajono;39;39 - Šakynos;501;255;246
45;Šiaulių rajono;40;40 - Žarėnų;341;171;170
46;Šilalės rajono;1;1 - Šilalės;2168;937;1231
46;Šilalės rajono;2;2 - Balsių;824;405;419
46;Šilalės rajono;3;3 - Bijotų;513;268;245
46;Šilalės rajono;4;4 - Bilionių;293;162;131
46;Šilalės rajono;5;5 - Bytlaukio;339;173;166
46;Šilalės rajono;6;6 - Biržų Lauko;444;233;211
46;Šilalės rajono;7;7 - Didkiemio;202;96;106
46;Šilalės rajono;8;8 - Gineikių;306;156;150
46;Šilalės rajono;9;9 - Girdiškės;157;83;74
46;Šilalės rajono;10;10 - Iždonų;209;105;104
46;Šilalės rajono;11;11 - Jomantų;478;246;232
46;Šilalės rajono;12;12 - Jucaičių;297;138;159
46;Šilalės rajono;13;13 - Kaltinėnų;946;450;496
46;Šilalės rajono;14;14 - Kvėdarnos;1797;874;923
46;Šilalės rajono;15;15 - Laukuvos;1261;605;656
46;Šilalės rajono;16;16 - Obelyno;527;262;265
46;Šilalės rajono;17;17 - Pajūrio;933;469;464
46;Šilalės rajono;18;18 - Pajūralio;625;317;308
46;Šilalės rajono;19;19 - Požerės;308;163;145
46;Šilalės rajono;20;20 - Šiauduvos;558;279;279
46;Šilalės rajono;21;21 - Tenenių;337;190;147
46;Šilalės rajono;22;22 - Traksėdžio;775;400;375
46;Šilalės rajono;23;23 - Upynos;631;307;324
46;Šilalės rajono;24;24 - Žadeikių;549;283;266
46;Šilalės rajono;25;25 - Ligoninės;967;458;509
46;Šilalės rajono;26;26 - Palentinio;194;98;96
46;Šilalės rajono;27;27 - Gimnazijos;1705;783;922
47;Šilutės rajono;1;1 - Mokyklos;1825;811;1014
47;Šilutės rajono;2;2 - Žalgirio;2137;949;1188
47;Šilutės rajono;3;3 - Martyno Jankaus;1311;545;766
47;Šilutės rajono;4;4 - Politechnikos;1605;666;939
47;Šilutės rajono;5;5 - Tilžės;2202;984;1218
47;Šilutės rajono;6;6 - Rusnės;1127;549;578
47;Šilutės rajono;7;7 - Gardamo;659;319;340
47;Šilutės rajono;8;8 - Ramučių;149;83;66
47;Šilutės rajono;9;9 - Šylių;457;224;233
47;Šilutės rajono;10;10 - Pagrynių;1698;864;834
47;Šilutės rajono;11;11 - Traksėdžių;1123;530;593
47;Šilutės rajono;12;12 - Jonaičių;389;192;197
47;Šilutės rajono;13;13 - Juknaičių;1092;548;544
47;Šilutės rajono;14;14 - Pašyšių;760;378;382
47;Šilutės rajono;16;16 - Grabupių;597;295;302
47;Šilutės rajono;17;17 - Macikų;701;367;334
47;Šilutės rajono;18;18 - Naujakurių;1854;856;998
47;Šilutės rajono;19;19 - Žemaitkiemio;221;115;106
47;Šilutės rajono;21;21 - Saugų;1178;595;583
47;Šilutės rajono;22;22 - Kintų;1164;588;576
47;Šilutės rajono;23;23 - Vilkyčių;987;473;514
47;Šilutės rajono;24;24 - Stubrių;203;105;98
47;Šilutės rajono;26;26 - Švėkšnos;1755;864;891
47;Šilutės rajono;27;27 - Inkaklių;496;247;249
47;Šilutės rajono;28;28 - Katyčių;504;258;246
47;Šilutės rajono;29;29 - Usėnų;849;413;436
47;Šilutės rajono;30;30 - Bikavėnų;283;153;130
47;Šilutės rajono;31;31 - Gorainių;242;116;126
47;Šilutės rajono;32;32 - Kivylių;335;167;168
47;Šilutės rajono;33;33 - Vainuto;639;302;337
47;Šilutės rajono;35;35 - Lietuvininkų;660;262;398
47;Šilutės rajono;36;36 - Liepų;973;421;552
47;Šilutės rajono;37;37 - Žemaičių Naumiesčio;905;417;488
47;Šilutės rajono;38;38 - Degučių;614;315;299
47;Šilutės rajono;39;39 - Naumiesčio kaimiškoji;781;380;401
48;Širvintų rajono;1;1 - Širvintų m.;2254;961;1293
48;Širvintų rajono;2;2 - I.Šeiniaus;2870;1297;1573
48;Širvintų rajono;3;3 - Juodiškių;291;153;138
48;Širvintų rajono;4;4 - Alionių;318;178;140
48;Širvintų rajono;5;5 - Čiobiškio;361;185;176
48;Širvintų rajono;6;6 - Virvyčių;228;108;120
48;Širvintų rajono;7;7 - Bagaslaviškio;291;140;151
48;Širvintų rajono;8;8 - Gelvonų;647;349;298
48;Širvintų rajono;10;10 - Bartkuškio;402;204;198
48;Širvintų rajono;11;11 - Šiaulių;400;206;194
48;Širvintų rajono;12;12 - Medžiukų;648;341;307
48;Širvintų rajono;13;13 - Kernavės;366;191;175
48;Širvintų rajono;14;14 - Musninkų;621;327;294
48;Širvintų rajono;15;15 - Vileikiškių;303;148;155
48;Širvintų rajono;16;16 - Alekniškio;168;86;82
48;Širvintų rajono;17;17 - Družų;394;210;184
48;Širvintų rajono;18;18 - Motiejūnų;273;137;136
48;Širvintų rajono;19;19 - Širvintų kaimiškoji;615;297;318
48;Širvintų rajono;20;20 - Anciūnų;253;132;121
48;Širvintų rajono;21;21 - Kiauklių;150;77;73
48;Širvintų rajono;22;22 - Šešuolėlių;441;228;213
48;Širvintų rajono;23;23 - Viesų;167;82;85
48;Širvintų rajono;24;24 - Kielių;372;191;181
49;Švenčionių rajono;1;1 - Švenčionėlių;2019;926;1093
49;Švenčionių rajono;2;2 - Ateities;1948;848;1100
49;Švenčionių rajono;3;3 - Kaltanėnų;325;162;163
49;Švenčionių rajono;4;4 - Labanoro;218;124;94
49;Švenčionių rajono;6;6 - Pašaminės;466;251;215
49;Švenčionių rajono;7;7 - Reškutėnų;196;98;98
49;Švenčionių rajono;8;8 - Trūdų;536;268;268
49;Švenčionių rajono;9;9 - Zadvarninkų;449;231;218
49;Švenčionių rajono;10;10 - Milkuškų;282;141;141
49;Švenčionių rajono;11;11 - Stanislavavo;175;104;71
49;Švenčionių rajono;12;12 - Šventos;342;188;154
49;Švenčionių rajono;14;14 - Svirkų;585;301;284
49;Švenčionių rajono;15;15 - Adutiškio;722;347;375
49;Švenčionių rajono;17;17 - Pabradės;1420;660;760
49;Švenčionių rajono;18;18 - Kranto;2610;1172;1438
49;Švenčionių rajono;19;19 - Švenčionių;1682;684;998
49;Švenčionių rajono;20;20 - Liepų;1769;841;928
49;Švenčionių rajono;21;21 - Cirkliškio;635;315;320
49;Švenčionių rajono;22;22 - Magūnų;291;156;135
49;Švenčionių rajono;23;23 - Prienų;243;130;113
49;Švenčionių rajono;24;24 - Karkažiškės;453;233;220
49;Švenčionių rajono;26;26 - Pavoverės;590;294;296
49;Švenčionių rajono;27;27 - Sarių;311;161;150
49;Švenčionių rajono;28;28 - Strūnaičio;377;203;174
49;Švenčionių rajono;29;29 - Vidutinės;455;239;216
50;Tauragės rajono;1;1 - Prezidento;2207;943;1264
50;Tauragės rajono;2;2 - J.Tumo-Vaižganto;3183;1282;1901
50;Tauragės rajono;3;3 - Tauragės;992;416;576
50;Tauragės rajono;4;4 - Dariaus ir Girėno;2111;1001;1110
50;Tauragės rajono;5;5 - Aerodromo;2863;1340;1523
50;Tauragės rajono;6;6 - Moksleivių;2670;1046;1624
50;Tauragės rajono;7;7 - Laisvės;2497;1133;1364
50;Tauragės rajono;9;9 - Melioratorių;1092;504;588
50;Tauragės rajono;10;10 - Taurų;1690;804;886
50;Tauragės rajono;11;11 - Lauksargių;881;434;447
50;Tauragės rajono;12;12 - Kęsčių;267;133;134
50;Tauragės rajono;13;13 - Sartininkų;490;258;232
50;Tauragės rajono;14;14 - Žygaičių;742;374;368
50;Tauragės rajono;16;16 - Aukštupių;334;172;162
50;Tauragės rajono;17;17 - Dapkiškių;454;240;214
50;Tauragės rajono;18;18 - Norkaičių;655;324;331
50;Tauragės rajono;19;19 - Pagramančio;511;248;263
50;Tauragės rajono;20;20 - Mažonų;670;336;334
50;Tauragės rajono;21;21 - Lomių;329;161;168
50;Tauragės rajono;22;22 - Šakviečio;257;132;125
50;Tauragės rajono;23;23 - Juodpetrių;952;505;447
50;Tauragės rajono;24;24 - Skaudvilės;1219;557;662
50;Tauragės rajono;25;25 - Adakavo;698;351;347
50;Tauragės rajono;26;26 - Trepų;331;162;169
50;Tauragės rajono;27;27 - Vaidilų;404;204;200
50;Tauragės rajono;28;28 - Batakių;660;330;330
50;Tauragės rajono;29;29 - Eidintų;320;150;170
50;Tauragės rajono;30;30 - Gaurės;565;269;296
50;Tauragės rajono;31;31 - Kunigiškių;451;240;211
50;Tauragės rajono;32;32 - Eičių;241;99;142
50;Tauragės rajono;33;33 - Baltrušaičių;449;226;223
50;Tauragės rajono;34;34 - Dauglaukio;379;191;188
50;Tauragės rajono;35;35 - Drąslaukio;512;255;257
51;Telšių rajono;1;1 - Lygumų;2310;991;1319
51;Telšių rajono;2;2 - Masčio;2846;1176;1670
51;Telšių rajono;3;3 - Respublikos;1338;544;794
51;Telšių rajono;4;4 - Žemaitės;2915;1356;1559
51;Telšių rajono;5;5 - Muziejaus;1930;895;1035
51;Telšių rajono;6;6 - Šviesos;1621;748;873
51;Telšių rajono;7;7 - Kalno;470;216;254
51;Telšių rajono;8;8 - Kęstučio;1246;519;727
51;Telšių rajono;9;9 - Sedos;1574;654;920
51;Telšių rajono;10;10 - Prano Genio;2158;975;1183
51;Telšių rajono;11;11 - Degaičių;760;382;378
51;Telšių rajono;12;12 - Eigirdžių;673;338;335
51;Telšių rajono;13;13 - Buožėnų;1018;509;509
51;Telšių rajono;14;14 - Gedrimų;336;169;167
51;Telšių rajono;15;15 - Nevarėnų;587;287;300
51;Telšių rajono;16;16 - Mitkaičių;229;124;105
51;Telšių rajono;17;17 - Nerimdaičių;229;116;113
51;Telšių rajono;18;18 - Ubiškės;820;419;401
51;Telšių rajono;19;19 - Tryškių;995;487;508
51;Telšių rajono;20;20 - Kaunatavos;458;218;240
51;Telšių rajono;21;21 - Upynos;435;210;225
51;Telšių rajono;22;22 - Kirklių;260;136;124
51;Telšių rajono;23;23 - Luokės;659;324;335
51;Telšių rajono;24;24 - Viekšnalių;273;137;136
51;Telšių rajono;25;25 - Kuršų;303;167;136
51;Telšių rajono;26;26 - Janapolės;484;250;234
51;Telšių rajono;27;27 - Pavandenės;414;210;204
51;Telšių rajono;28;28 - Varnių;1608;786;822
51;Telšių rajono;29;29 - Žarėnų;696;340;356
51;Telšių rajono;30;30 - Ryškėnų;1977;994;983
51;Telšių rajono;31;31 - Viešvėnų;734;378;356
51;Telšių rajono;32;32 - Vembūtų;344;188;156
51;Telšių rajono;33;33 - Rainių;883;418;465
52;Trakų rajono;1;1 - Lentvario;2399;1022;1377
52;Trakų rajono;2;2 - Klevų;2683;1192;1491
52;Trakų rajono;3;3 - Trakų m.;2178;895;1283
52;Trakų rajono;10;10 - Ismonių;207;106;101
52;Trakų rajono;11;11 - Tiltų;266;134;132
52;Trakų rajono;12;12 - Rūdiškių;1906;902;1004
52;Trakų rajono;13;13 - Šklėrių;455;236;219
52;Trakų rajono;14;14 - Aukštadvario;1071;516;555
52;Trakų rajono;15;15 - Čižiūnų;331;164;167
52;Trakų rajono;17;17 - Grendavės;442;223;219
52;Trakų rajono;21;21 - Rykantų;1604;833;771
52;Trakų rajono;22;22 - Dusmenų;267;132;135
52;Trakų rajono;23;23 - Onuškio;758;381;377
52;Trakų rajono;24;24 - Vaickūniškių;262;136;126
52;Trakų rajono;25;25 - Paluknio;988;487;501
52;Trakų rajono;27;27 - Bijūnų;341;177;164
52;Trakų rajono;30;30 - Senojo Tarpupio;303;146;157
52;Trakų rajono;31;31 - Senųjų Trakų;1592;752;840
52;Trakų rajono;32;32 - Šventininkų;609;314;295
52;Trakų rajono;33;33 - Bražuolės;866;462;404
52;Trakų rajono;34;34 - Žaizdrių;972;496;476
52;Trakų rajono;35;35 - Jovariškių;332;175;157
52;Trakų rajono;40;40 - Salkininkų;431;205;226
52;Trakų rajono;41;41 - Birutės;1800;835;965
52;Trakų rajono;42;42 - Bagdononių;281;159;122
52;Trakų rajono;43;43 - Lauko;2462;1140;1322
52;Trakų rajono;44;44 - Kilimų;1801;829;972
53;Ukmergės rajono;2;2 - Anykščių;2462;1001;1461
53;Ukmergės rajono;3;3 - Maironio;1553;670;883
53;Ukmergės rajono;4;4 - J.Basanavičiaus;1350;594;756
53;Ukmergės rajono;6;6 - Kęstučio;1699;767;932
53;Ukmergės rajono;9;9 - Kauno;1886;795;1091
53;Ukmergės rajono;10;10 - Smėlių;1212;565;647
53;Ukmergės rajono;11;11 - Krekšlių;2368;1123;1245
53;Ukmergės rajono;12;12 - Linų;2348;1037;1311
53;Ukmergės rajono;13;13 - Pivonijos;2051;824;1227
53;Ukmergės rajono;14;14 - Pašilės;711;331;380
53;Ukmergės rajono;15;15 - Siesikų;999;493;506
53;Ukmergės rajono;18;18 - Taujėnų;1075;553;522
53;Ukmergės rajono;21;21 - Vidiškių;1161;575;586
53;Ukmergės rajono;22;22 - Rečionių;895;437;458
53;Ukmergės rajono;23;23 - Deltuvos;1487;731;756
53;Ukmergės rajono;24;24 - Dainavos;621;313;308
53;Ukmergės rajono;26;26 - Lyduokių;355;179;176
53;Ukmergės rajono;28;28 - Pabaisko;700;352;348
53;Ukmergės rajono;30;30 - Šešuolių;580;303;277
53;Ukmergės rajono;32;32 - Antakalnio;356;190;166
53;Ukmergės rajono;33;33 - Krikštėnų;257;138;119
53;Ukmergės rajono;34;34 - Laičių;476;231;245
53;Ukmergės rajono;35;35 - Veprių;815;391;424
53;Ukmergės rajono;37;37 - Želvos;761;380;381
53;Ukmergės rajono;40;40 - Žemaitkiemio;513;262;251
54;Utenos rajono;1;1 - Aukštakalnio;1740;758;982
54;Utenos rajono;2;2 - Taikos;2137;853;1284
54;Utenos rajono;3;3 - Aušros;1947;803;1144
54;Utenos rajono;4;4 - Dauniškio;1698;716;982
54;Utenos rajono;5;5 - Vyturių;1450;628;822
54;Utenos rajono;6;6 - Centro;865;356;509
54;Utenos rajono;7;7 - Basanavičiaus;1105;537;568
54;Utenos rajono;8;8 - Ąžuolijos;1924;900;1024
54;Utenos rajono;9;9 - Krašuonos;2058;923;1135
54;Utenos rajono;10;10 - Daugailių;438;229;209
54;Utenos rajono;11;11 - Radeikių;395;215;180
54;Utenos rajono;12;12 - Juknėnų;168;79;89
54;Utenos rajono;13;13 - Kuktiškių;596;293;303
54;Utenos rajono;14;14 - Leliūnų;494;252;242
54;Utenos rajono;15;15 - Antalgės;956;482;474
54;Utenos rajono;16;16 - Pakalnių;910;464;446
54;Utenos rajono;17;17 - Saldutiškio;404;195;209
54;Utenos rajono;18;18 - Kirdeikių;231;128;103
54;Utenos rajono;19;19 - Sudeikių;547;278;269
54;Utenos rajono;20;20 - Sirutėnų;564;304;260
54;Utenos rajono;21;21 - Tauragnų;928;466;462
54;Utenos rajono;22;22 - Pačkėnų;725;371;354
54;Utenos rajono;23;23 - Biliakiemio;635;319;316
54;Utenos rajono;24;24 - Vaikutėnų;434;230;204
54;Utenos rajono;25;25 - Užpalių;822;405;417
54;Utenos rajono;26;26 - Kaniukų;259;133;126
54;Utenos rajono;27;27 - Vilučių;134;65;69
54;Utenos rajono;28;28 - Vyžuonų;883;461;422
54;Utenos rajono;29;29 - Senamiesčio;1740;834;906
54;Utenos rajono;30;30 - Naujasodžio;1872;872;1000
54;Utenos rajono;31;31 - Smėlio;1704;741;963
54;Utenos rajono;32;32 - Sodų;1287;548;739
55;Varėnos rajono;1;1 - Puodžių;439;221;218
55;Varėnos rajono;2;2 - Žilinų;407;204;203
55;Varėnos rajono;3;3 - Dubičių;342;178;164
55;Varėnos rajono;4;4 - Panočių;374;202;172
55;Varėnos rajono;5;5 - Kabelių;298;161;137
55;Varėnos rajono;6;6 - Marcinkonių;636;326;310
55;Varėnos rajono;10;10 - Krūminių;366;200;166
55;Varėnos rajono;11;11 - Matuizų;1104;517;587
55;Varėnos rajono;14;14 - Kibyšių;196;96;100
55;Varėnos rajono;15;15 - Merkinės;1265;607;658
55;Varėnos rajono;16;16 - Panaros;199;107;92
55;Varėnos rajono;17;17 - Vilkiautinio;328;169;159
55;Varėnos rajono;18;18 - Pilvingių;278;150;128
55;Varėnos rajono;24;24 - Daržininkų;176;101;75
55;Varėnos rajono;25;25 - Dargužių;268;141;127
55;Varėnos rajono;26;26 - Valkininkų;639;312;327
55;Varėnos rajono;27;27 - Pušelės;497;241;256
55;Varėnos rajono;28;28 - Gudžių;325;169;156
55;Varėnos rajono;29;29 - Nedzingės;215;118;97
55;Varėnos rajono;30;30 - Perlojos;466;231;235
55;Varėnos rajono;31;31 - Sarapiniškių;224;112;112
55;Varėnos rajono;32;32 - Tolkūnų;337;173;164
55;Varėnos rajono;33;33 - Krivilių;304;166;138
55;Varėnos rajono;34;34 - Vydenių;637;319;318
55;Varėnos rajono;35;35 - Rudnios;160;85;75
55;Varėnos rajono;36;36 - Parko;2328;966;1362
55;Varėnos rajono;37;37 - Dzūkų;1886;772;1114
55;Varėnos rajono;38;38 - Šilo;2284;985;1299
55;Varėnos rajono;39;39 - Senosios Varėnos;985;499;486
56;Vilkaviškio rajono;1;1 - Vilkaviškio rytų;2112;973;1139
56;Vilkaviškio rajono;2;2 - Vilkaviškio pietų;2226;1031;1195
56;Vilkaviškio rajono;3;3 - Vilkaviškio vakarų;1784;699;1085
56;Vilkaviškio rajono;4;4 - Vilkaviškio šiaurės;2637;1115;1522
56;Vilkaviškio rajono;5;5 - Kybartų rytų;1703;801;902
56;Vilkaviškio rajono;6;6 - Kybartų vakarų;1702;718;984
56;Vilkaviškio rajono;7;7 - Virbalio;1237;591;646
56;Vilkaviškio rajono;9;9 - Bartninkų;820;425;395
56;Vilkaviškio rajono;10;10 - Lakštučių;465;233;232
56;Vilkaviškio rajono;11;11 - Pašeimenių;284;148;136
56;Vilkaviškio rajono;13;13 - Gižų;686;351;335
56;Vilkaviškio rajono;14;14 - Bačkiškių;358;178;180
56;Vilkaviškio rajono;15;15 - Karklinių;513;259;254
56;Vilkaviškio rajono;16;16 - Keturvalakių;329;153;176
56;Vilkaviškio rajono;17;17 - Gudkaimio;476;245;231
56;Vilkaviškio rajono;18;18 - Lauckaimio;349;184;165
56;Vilkaviškio rajono;19;19 - Matlaukio;493;248;245
56;Vilkaviškio rajono;20;20 - Šiaudiniškių;221;111;110
56;Vilkaviškio rajono;23;23 - Daržininkų;303;143;160
56;Vilkaviškio rajono;24;24 - Klausučių;534;272;262
56;Vilkaviškio rajono;25;25 - Sūdavos;914;458;456
56;Vilkaviškio rajono;26;26 - Karalkrėslio;350;176;174
56;Vilkaviškio rajono;27;27 - Pajevonio;541;271;270
56;Vilkaviškio rajono;28;28 - Alksnėnų;329;174;155
56;Vilkaviškio rajono;29;29 - Opšrūtų;242;122;120
56;Vilkaviškio rajono;30;30 - Paežerių;490;236;254
56;Vilkaviškio rajono;31;31 - Pilviškių;1788;834;954
56;Vilkaviškio rajono;32;32 - Ramoniškių;335;168;167
56;Vilkaviškio rajono;33;33 - Alvito;1009;477;532
56;Vilkaviškio rajono;34;34 - Giedrių;837;402;435
56;Vilkaviškio rajono;35;35 - Klampučių;299;153;146
56;Vilkaviškio rajono;36;36 - Serdokų;228;117;111
56;Vilkaviškio rajono;37;37 - Uosių;578;287;291
56;Vilkaviškio rajono;38;38 - Gražiškių;606;313;293
56;Vilkaviškio rajono;39;39 - Girėnų;294;153;141
56;Vilkaviškio rajono;40;40 - Vištyčio;413;200;213
56;Vilkaviškio rajono;42;42 - Pūstapėdžių;432;224;208
56;Vilkaviškio rajono;43;43 - Slabadų;168;87;81
56;Vilkaviškio rajono;44;44 - Stirniškių;471;243;228
57;Vilniaus miesto;2;2 - Gedimino;3007;1366;1641
57;Vilniaus miesto;3;3 - Saltoniškių;3054;1310;1744
57;Vilniaus miesto;4;4 - Sėlių;2115;941;1174
57;Vilniaus miesto;6;6 - Vytauto;2560;1157;1403
57;Vilniaus miesto;7;7 - Birutės;1869;808;1061
57;Vilniaus miesto;8;8 - Pamėnkalnio;2219;963;1256
57;Vilniaus miesto;10;10 - Taurakalnio;1744;777;967
57;Vilniaus miesto;12;12 - S. Konarskio;3170;1336;1834
57;Vilniaus miesto;13;13 - Mindaugo;2168;909;1259
57;Vilniaus miesto;15;15 - Vytenio;2783;1217;1566
57;Vilniaus miesto;16;16 - Žemaitės;3667;1611;2056
57;Vilniaus miesto;17;17 - Algirdo;3979;1771;2208
57;Vilniaus miesto;23;23 - Visorių;4436;2037;2399
57;Vilniaus miesto;24;24 - Muitininkų;3554;1683;1871
57;Vilniaus miesto;25;25 - Kauno Vokės;2990;1347;1643
57;Vilniaus miesto;26;26 - Kunigiškių;2938;1241;1697
57;Vilniaus miesto;27;27 - Šviesos;2250;951;1299
57;Vilniaus miesto;48;48 - Trakų Vokės;3810;1834;1976
57;Vilniaus miesto;50;50 - Melioratorių;3335;1518;1817
57;Vilniaus miesto;51;51 - Dailės;1726;778;948
57;Vilniaus miesto;52;52 - Užupio;2760;1193;1567
57;Vilniaus miesto;53;53 - A. Krutulio;3794;1639;2155
57;Vilniaus miesto;54;54 - A. Juozapavičiaus;3087;1347;1740
57;Vilniaus miesto;55;55 - Didlaukio;2954;1240;1714
57;Vilniaus miesto;56;56 - Licėjaus;4245;1905;2340
57;Vilniaus miesto;57;57 - Senvagės;3060;1246;1814
57;Vilniaus miesto;59;59 - Konstitucijos;3884;1822;2062
57;Vilniaus miesto;60;60 - Senamiesčio;1891;831;1060
57;Vilniaus miesto;62;62 - Naugarduko;3113;1379;1734
57;Vilniaus miesto;65;65 - A. Vienuolio;1754;781;973
57;Vilniaus miesto;66;66 - M. Daukšos;2943;1304;1639
57;Vilniaus miesto;67;67 - V. Šopeno;2075;913;1162
57;Vilniaus miesto;68;68 - Gerviškių;2398;1077;1321
57;Vilniaus miesto;78;78 - Liudvinavo;3187;1584;1603
57;Vilniaus miesto;101;101 - Filaretų;2455;1063;1392
57;Vilniaus miesto;102;102 - Olandų;1521;644;877
57;Vilniaus miesto;104;104 - L. Sapiegos;2831;1181;1650
57;Vilniaus miesto;105;105 - Šilo;3742;1596;2146
57;Vilniaus miesto;107;107 - Antakalnio;2781;1090;1691
57;Vilniaus miesto;109;109 - Švyturio;3348;1407;1941
57;Vilniaus miesto;111;111 - B. Sruogos;3954;1672;2282
57;Vilniaus miesto;112;112 - Saulėtekio;1857;869;988
57;Vilniaus miesto;113;113 - Valakupių;2602;1216;1386
57;Vilniaus miesto;115;115 - Markučių;4029;1831;2198
57;Vilniaus miesto;116;116 - Liepkalnio;3715;1620;2095
57;Vilniaus miesto;120;120 - Antavilių;3104;1423;1681
57;Vilniaus miesto;121;121 - Dvarčionių;3134;1510;1624
57;Vilniaus miesto;122;122 - Kairėnų;2235;1069;1166
57;Vilniaus miesto;151;151 - Žirmūnų;2010;806;1204
57;Vilniaus miesto;152;152 - Kareivių;1709;663;1046
57;Vilniaus miesto;153;153 - Prekybininkų;2986;1288;1698
57;Vilniaus miesto;154;154 - Miestelio;1852;738;1114
57;Vilniaus miesto;155;155 - Moksleivių;2530;994;1536
57;Vilniaus miesto;156;156 - Raitininkų;2702;1164;1538
57;Vilniaus miesto;157;157 - Sporto;2223;897;1326
57;Vilniaus miesto;158;158 - Kazliškių;1889;757;1132
57;Vilniaus miesto;159;159 - Rinktinės;1746;716;1030
57;Vilniaus miesto;160;160 - Tuskulėnų;2694;1125;1569
57;Vilniaus miesto;162;162 - Minties;2805;1120;1685
57;Vilniaus miesto;166;166 - Kalvarijų;2962;1226;1736
57;Vilniaus miesto;167;167 - S. Žukausko;2479;1053;1426
57;Vilniaus miesto;168;168 - Žygio;2767;1184;1583
57;Vilniaus miesto;199;199 - Žaliųjų Ežerų;2585;1267;1318
57;Vilniaus miesto;200;200 - Balsių;3790;1843;1947
57;Vilniaus miesto;201;201 - Popieriaus;4047;1966;2081
57;Vilniaus miesto;202;202 - Mokyklos;4116;1834;2282
57;Vilniaus miesto;203;203 - Baltupių;4100;1831;2269
57;Vilniaus miesto;204;204 - Gabijos;3933;1657;2276
57;Vilniaus miesto;205;205 - Fabijoniškių;4080;1758;2322
57;Vilniaus miesto;206;206 - Jovaro;3167;1334;1833
57;Vilniaus miesto;207;207 - S. Stanevičiaus;3124;1342;1782
57;Vilniaus miesto;208;208 - Kaimelio;2547;1116;1431
57;Vilniaus miesto;209;209 - L. Giros;3102;1363;1739
57;Vilniaus miesto;210;210 - P. Žadeikos;1898;819;1079
57;Vilniaus miesto;211;211 - Gedvydžių;2669;1164;1505
57;Vilniaus miesto;212;212 - Rugių;4153;1849;2304
57;Vilniaus miesto;213;213 - S. Nėries;3799;1646;2153
57;Vilniaus miesto;214;214 - Pavilnionių;3628;1612;2016
57;Vilniaus miesto;215;215 - Bajorų;3663;1639;2024
57;Vilniaus miesto;216;216 - J. Baltrušaičio;2926;1272;1654
57;Vilniaus miesto;217;217 - Tarandės;2612;1256;1356
57;Vilniaus miesto;218;218 - Perkūnkiemio;4132;1809;2323
57;Vilniaus miesto;219;219 - Grigalaukio;3213;1437;1776
57;Vilniaus miesto;252;252 - Viršuliškių;2334;955;1379
57;Vilniaus miesto;253;253 - Lūžių;2423;997;1426
57;Vilniaus miesto;254;254 - Mokslo;3442;1401;2041
57;Vilniaus miesto;255;255 - Čiobiškio;3003;1231;1772
57;Vilniaus miesto;256;256 - Musninkų;3085;1293;1792
57;Vilniaus miesto;257;257 - Dūkštų;2237;939;1298
57;Vilniaus miesto;258;258 - Šeškinės;1939;777;1162
57;Vilniaus miesto;259;259 - Ukmergės;3266;1383;1883
57;Vilniaus miesto;260;260 - Žygimanto Augusto;2457;1010;1447
57;Vilniaus miesto;261;261 - Paberžės;2594;1096;1498
57;Vilniaus miesto;262;262 - Gelvonų;3427;1429;1998
57;Vilniaus miesto;301;301 - Rygos;3233;1384;1849
57;Vilniaus miesto;302;302 - Taikos;3853;1571;2282
57;Vilniaus miesto;303;303 - Justiniškių;4091;1770;2321
57;Vilniaus miesto;304;304 - M. Biržiškos;3226;1368;1858
57;Vilniaus miesto;305;305 - Statybininkų;2812;1185;1627
57;Vilniaus miesto;306;306 - Sietuvos;3196;1340;1856
57;Vilniaus miesto;307;307 - Žemynos;3722;1575;2147
57;Vilniaus miesto;308;308 - Medeinos;3081;1306;1775
57;Vilniaus miesto;309;309 - Pašilaičių;3296;1425;1871
57;Vilniaus miesto;310;310 - Papilėnų;3964;1734;2230
57;Vilniaus miesto;311;311 - Įsruties;4093;1793;2300
57;Vilniaus miesto;312;312 - Vydūno;3683;1580;2103
57;Vilniaus miesto;313;313 - Salotės;2297;1055;1242
57;Vilniaus miesto;351;351 - Tujų;2693;1123;1570
57;Vilniaus miesto;352;352 - Sausio 13-osios;2473;1029;1444
57;Vilniaus miesto;353;353 - Bokšto;2676;1082;1594
57;Vilniaus miesto;356;356 - L. Asanavičiūtės;2490;987;1503
57;Vilniaus miesto;357;357 - V. Druskio;2164;901;1263
57;Vilniaus miesto;358;358 - R. Jankausko;1690;665;1025
57;Vilniaus miesto;359;359 - D. Gerbutavičiaus;1918;777;1141
57;Vilniaus miesto;360;360 - Sietyno;2218;904;1314
57;Vilniaus miesto;361;361 - A. P. Kavoliuko;2658;1076;1582
57;Vilniaus miesto;362;362 - V. Vaitkaus;1879;784;1095
57;Vilniaus miesto;363;363 - A. J. Povilaičio;1930;805;1125
57;Vilniaus miesto;364;364 - Laisvės;2331;945;1386
57;Vilniaus miesto;369;369 - Pilaitės;2348;1149;1199
57;Vilniaus miesto;370;370 - Kriaučiūnų;548;249;299
57;Vilniaus miesto;371;371 - Smalinės;3482;1593;1889
57;Vilniaus miesto;372;372 - Karaliaučiaus;2509;1061;1448
57;Vilniaus miesto;401;401 - Vingio;2274;973;1301
57;Vilniaus miesto;403;403 - Geležinio Vilko;1733;732;1001
57;Vilniaus miesto;407;407 - Skroblų;2804;1187;1617
57;Vilniaus miesto;408;408 - Vilkpėdės;2198;943;1255
57;Vilniaus miesto;409;409 - Gerosios Vilties;2800;1123;1677
57;Vilniaus miesto;410;410 - Riešuto;2932;1265;1667
57;Vilniaus miesto;411;411 - Titnago;3508;1555;1953
57;Vilniaus miesto;412;412 - Aukštųjų Panerių;1138;524;614
57;Vilniaus miesto;413;413 - Bukčių;4281;2003;2278
57;Vilniaus miesto;414;414 - Akacijų;2182;917;1265
57;Vilniaus miesto;415;415 - Oslo;4225;1816;2409
57;Vilniaus miesto;416;416 - Žėručio;2519;1049;1470
57;Vilniaus miesto;417;417 - Paparčio;2791;1206;1585
57;Vilniaus miesto;451;451 - Salininkų;3464;1645;1819
57;Vilniaus miesto;452;452 - Lietuvių namų;1917;831;1086
57;Vilniaus miesto;453;453 - Dzūkų;2874;1216;1658
57;Vilniaus miesto;454;454 - Kapsų;1744;735;1009
57;Vilniaus miesto;456;456 - Kaminkelio;2607;1153;1454
57;Vilniaus miesto;457;457 - Naujininkų;2769;1163;1606
57;Vilniaus miesto;458;458 - Brolių;2687;1114;1573
57;Vilniaus miesto;460;460 - Kirtimų;1356;655;701
57;Vilniaus miesto;461;461 - Palydovo;2545;1199;1346
57;Vilniaus miesto;462;462 - Rugiagėlių;2291;1085;1206
57;Vilniaus miesto;463;463 - A. Kojelavičiaus;1528;729;799
57;Vilniaus miesto;464;464 - Užusienio;1382;676;706
57;Vilniaus miesto;465;465 - Genių;1446;592;854
57;Vilniaus miesto;466;466 - Pergalės;2940;1300;1640
57;Vilniaus miesto;467;467 - Darželio;1748;695;1053
57;Vilniaus miesto;468;468 - Karklėnų;2736;1145;1591
57;Vilniaus miesto;469;469 - J. Kolaso;2696;1285;1411
57;Vilniaus miesto;470;470 - Parko;3566;1520;2046
57;Vilniaus miesto;471;471 - Pramonės;1472;685;787
57;Vilniaus miesto;472;472 - Džiaugsmo;4014;1934;2080
57;Vilniaus miesto;473;473 - Kalnėnų;2776;1302;1474
58;Vilniaus rajono;1;1 - Avižienių 1-oji;2115;1094;1021
58;Vilniaus rajono;2;2 - Riešės 1-oji;1674;818;856
58;Vilniaus rajono;3;3 - Buivydžių;719;366;353
58;Vilniaus rajono;4;4 - Buivydiškių;2251;1091;1160
58;Vilniaus rajono;5;5 - Platiniškių;1203;629;574
58;Vilniaus rajono;6;6 - Čekoniškių;1444;765;679
58;Vilniaus rajono;7;7 - Bezdonių 1-oji;1402;715;687
58;Vilniaus rajono;8;8 - Baltosios Vokės;1260;580;680
58;Vilniaus rajono;9;9 - Pagirių 1-oji;1616;751;865
58;Vilniaus rajono;10;10 - Keturiasdešimties Totorių;1277;620;657
58;Vilniaus rajono;11;11 - Grigaičių;1362;670;692
58;Vilniaus rajono;12;12 - Kyviškių;1193;565;628
58;Vilniaus rajono;13;13 - Dūkštų;1146;611;535
58;Vilniaus rajono;14;14 - Geisiškių;611;322;289
58;Vilniaus rajono;15;15 - Pakenės;737;380;357
58;Vilniaus rajono;16;16 - Kalvelių;1471;684;787
58;Vilniaus rajono;17;17 - Šumsko;1106;544;562
58;Vilniaus rajono;18;18 - Mostiškių;758;376;382
58;Vilniaus rajono;19;19 - Lavoriškių;1092;539;553
58;Vilniaus rajono;20;20 - Maišiagalos;1437;672;765
58;Vilniaus rajono;21;21 - Karvio;1021;538;483
58;Vilniaus rajono;22;22 - Marijampolio;1246;625;621
58;Vilniaus rajono;23;23 - Parudaminio;830;405;425
58;Vilniaus rajono;24;24 - Mickūnų 1-oji;1649;802;847
58;Vilniaus rajono;25;25 - Galgių;1960;967;993
58;Vilniaus rajono;26;26 - Medininkų;843;427;416
58;Vilniaus rajono;27;27 - Nemėžio 1-oji;1975;975;1000
58;Vilniaus rajono;28;28 - Skaidiškių 1-oji;2033;966;1067
58;Vilniaus rajono;29;29 - Kabiškių;823;407;416
58;Vilniaus rajono;30;30 - Rudausių;809;399;410
58;Vilniaus rajono;32;32 - Eitminiškių;699;352;347
58;Vilniaus rajono;33;33 - Paberžės;1601;768;833
58;Vilniaus rajono;34;34 - Glitiškių;537;266;271
58;Vilniaus rajono;35;35 - Visalaukės;469;249;220
58;Vilniaus rajono;36;36 - Didžiosios Riešės 1-oji;1946;986;960
58;Vilniaus rajono;37;37 - Pikeliškių;2304;1176;1128
58;Vilniaus rajono;38;38 - Rudaminos 1-oji;1967;935;1032
58;Vilniaus rajono;39;39 - Kalviškių;829;375;454
58;Vilniaus rajono;40;40 - Valčiūnų;1728;802;926
58;Vilniaus rajono;41;41 - Rukainių;1364;681;683
58;Vilniaus rajono;42;42 - Senasalio;345;178;167
58;Vilniaus rajono;43;43 - Savičiūnų;518;271;247
58;Vilniaus rajono;44;44 - Sudervės 1-oji;1435;748;687
58;Vilniaus rajono;45;45 - Sužionių;551;272;279
58;Vilniaus rajono;46;46 - Veriškių;535;259;276
58;Vilniaus rajono;47;47 - Skirlėnų;333;172;161
58;Vilniaus rajono;48;48 - Mažųjų Lygainių;443;229;214
58;Vilniaus rajono;49;49 - Juodšilių;2012;938;1074
58;Vilniaus rajono;51;51 - Nemenčinės;2009;900;1109
58;Vilniaus rajono;52;52 - Neries;1728;756;972
58;Vilniaus rajono;53;53 - Bukiškio 1-oji;1943;961;982
58;Vilniaus rajono;54;54 - Kreivalaužių;861;404;457
58;Vilniaus rajono;55;55 - Rakonių;931;493;438
58;Vilniaus rajono;56;56 - Antežerių;2089;1062;1027
58;Vilniaus rajono;57;57 - Avižienių 2-oji;1581;803;778
58;Vilniaus rajono;58;58 - Riešės 2-oji;1265;654;611
58;Vilniaus rajono;59;59 - Bukiškio 2-oji;1768;916;852
58;Vilniaus rajono;60;60 - Sudervės 2-oji;1195;612;583
58;Vilniaus rajono;61;61 - Didžiosios Riešės 2-oji;1985;971;1014
58;Vilniaus rajono;62;62 - Bezdonių 2-oji;1200;643;557
58;Vilniaus rajono;63;63 - Mickūnų 2-oji;1623;802;821
58;Vilniaus rajono;64;64 - Nemėžio 2-oji;2110;1026;1084
58;Vilniaus rajono;65;65 - Skaidiškių 2-oji;1799;842;957
58;Vilniaus rajono;66;66 - Rudaminos 2-oji;1983;928;1055
58;Vilniaus rajono;67;67 - Pagirių 2-oji;1438;664;774
59;Visagino;1;1 - Draugystės;1721;819;902
59;Visagino;2;2 - Gerosios Vilties;1784;764;1020
59;Visagino;3;3 - Auksinio raktelio;1308;534;774
59;Visagino;4;4 - Bangos;1577;672;905
59;Visagino;5;5 - Auksinio gaidelio;1295;593;702
59;Visagino;6;6 - Atgimimo;1194;538;656
59;Visagino;7;7 - Vilties šaltinio;1221;548;673
59;Visagino;8;8 - Gintarėlio;1611;736;875
59;Visagino;9;9 - Ateities;1818;827;991
59;Visagino;10;10 - Žiburio;1939;900;1039
60;Zarasų rajono;1;1 - Antalieptės;473;242;231
60;Zarasų rajono;2;2 - Antazavės;399;209;190
60;Zarasų rajono;3;3 - Šniukštų;250;127;123
60;Zarasų rajono;4;4 - Baibių;350;186;164
60;Zarasų rajono;5;5 - Degučių;280;132;148
60;Zarasų rajono;6;6 - Avilių;286;153;133
60;Zarasų rajono;7;7 - Imbrado;406;219;187
60;Zarasų rajono;9;9 - Salako;718;378;340
60;Zarasų rajono;11;11 - Suvieko;429;225;204
60;Zarasų rajono;12;12 - Dimitriškių;480;235;245
60;Zarasų rajono;13;13 - Magučių;368;199;169
60;Zarasų rajono;15;15 - Štadvilių;508;273;235
60;Zarasų rajono;17;17 - Smalvų;183;102;81
60;Zarasų rajono;18;18 - Turmanto;717;363;354
60;Zarasų rajono;19;19 - Dusetų;1801;865;936
60;Zarasų rajono;22;22 - Zarasų rytų;2451;1037;1414
60;Zarasų rajono;23;23 - Zarasų vakarų;1434;673;761
60;Zarasų rajono;24;24 - Zarasų šiaurės;1452;630;822
61;Užsienio;1;1 - Ambasada Airijoje;3482;1495;1987
61;Užsienio;3;3 - Ambasada Armėnijos ;9;4;5
61;Užsienio;5;5 - Ambasada Austrijos Respublikoje;314;90;224
61;Užsienio;6;6 - Ambasada Azerbaidžano ;16;8;8
61;Užsienio;8;8 - Ambasada Belgijos Karalystėje;1632;511;1121
61;Užsienio;11;11 - Ambasada Čekijos Respublikoje;125;49;76
61;Užsienio;12;12 - Ambasada Danijos Karalystėje;1920;741;1179
61;Užsienio;13;13 - Ambasada Egipto Arabų ;39;7;32
61;Užsienio;14;14 - Ambasada Estijos Respublikoje;137;57;80
61;Užsienio;15;15 - Ambasada Graikijos ;298;57;241
61;Užsienio;16;16 - Ambasada Sakartvele;41;14;27
61;Užsienio;18;18 - Ambasada Italijos Respublikoje;793;104;689
61;Užsienio;19;19 - Ambasada Izraelio Valstybėje;218;110;108
61;Užsienio;20;20 - Ambasada Japonijoje;143;59;84
61;Užsienio;24;24 - Ambasada Kazachstano ;15;11;4
61;Užsienio;25;25 - Generalinis konsulatas Almatoje;17;10;7
61;Užsienio;27;27 - Ambasada Latvijos Respublikoje;129;62;67
61;Užsienio;29;29 - Ambasada Moldovos ;7;4;3
61;Užsienio;30;30 - Ambasada Nyderlandų ;1681;580;1101
61;Užsienio;31;31 - Ambasada Norvegijos ;4087;1888;2199
61;Užsienio;33;33 - Ambasada Prancūzijos ;1036;224;812
61;Užsienio;34;34 - Ambasada Rumunijoje;48;8;40
61;Užsienio;37;37 - Ambasada Suomijos ;286;96;190
61;Užsienio;38;38 - Ambasada Švedijos Karalystėje;1968;799;1169
61;Užsienio;40;40 - Ambasada Turkijos ;184;28;156
61;Užsienio;41;41 - Ambasada Ukrainoje;48;32;16
61;Užsienio;43;43 - Ambasada Vengrijoje;45;12;33
61;Užsienio;46;46 - Ambasada Indijos Respublikoje;20;6;14
61;Užsienio;47;47 - Generalinis konsulatas San Paule;158;77;81
61;Užsienio;48;48 - Ambasada Baltarusijos ;20;9;11
61;Užsienio;50;50 - Ambasada Ispanijos Karalystėje;785;224;561
61;Užsienio;51;51 - Konsulatas Valensijoje;666;200;466
61;Užsienio;52;52 - Ambasada Jungtinėse Amerikos ;410;148;262
61;Užsienio;53;53 - Generalinis konsulatas Čikagoje;2764;1158;1606
61;Užsienio;54;54 - Generalinis konsulatas Niujorke;1898;748;1150
61;Užsienio;55;55 - Ambasada Jungtinėje ;19505;7163;12342
61;Užsienio;56;56 - Ambasada Kanadoje;761;301;460
61;Užsienio;58;58 - Ambasada Lenkijos ;295;129;166
61;Užsienio;59;59 - Konsulatas Seinuose;31;16;15
61;Užsienio;60;60 - Ambasada Rusijos Federacijoje;65;31;34
61;Užsienio;62;62 - Generalinis konsulatas ;36;16;20
61;Užsienio;63;63 - Konsulatas Sovetske;7;2;5
61;Užsienio;64;64 - Ambasada Vokietijos ;3411;1083;2328
61;Užsienio;66;66 - Ambasada Kroatijoje;44;13;31
61;Užsienio;68;68 - Ambasada Pietų Afrikos ;201;95;106
61;Užsienio;69;69 - Generalinis konsulatas Los ;1088;431;657
61;Užsienio;70;70 - Ambasada Jungtiniuose Arabų ;199;69;130
61;Užsienio;71;71 - Ambasada Australijoje;940;329;611
61;Užsienio;72;72 - Ambasada Singapūro ;147;70;77
61;Užsienio;73;73 - Ambasada Pietų Korėjoje;78;34;44
61;Užsienio;74;74 - Ambasada Šveicarijos ;1228;450;778
61;Užsienio;75;75 - Generalinis konsulatas ;87;33;54
